YEAR,ethnicity,label,prediction,pred_adj_scaled,pred_adj_full_scaled,n,log_n,label_imp_date,prediction_imp_date,pred_adj_scaled_imp_date,pred_adj_full_scaled_imp_date,n_imp_date,log_n_imp_date
1921,Altai,0,3,3,4,4,1.6094379124341003,1,3,2,3,4,1.6094379124341003
1921,Armenian,5,10,10,10,15,2.772588722239781,5,14,14,14,19,2.995732273553991
1921,Balkar,0,0,0,0,0,0,0,0,0,0,0,0
1921,Bashkir,21,8,0,10,31,3.4657359027997265,21,9,0,10,31,3.4657359027997265
1921,Belorussian,136,122,81,103,239,5.480638923341991,145,142,70,101,246,5.5093883366279774
1921,Bulgarian,1,3,0,0,1,0.6931471805599453,2,3,0,0,2,1.0986122886681098
1921,Buryat,2,8,9,9,11,2.4849066497880004,3,10,11,11,14,2.70805020110221
1921,Estonian,15,28,20,24,39,3.6888794541139363,15,32,20,25,40,3.713572066704308
1921,Finnish,1,19,13,13,14,2.70805020110221,1,20,10,11,12,2.5649493574615367
1921,Georgian,4,8,6,6,10,2.3978952727983707,4,9,6,6,10,2.3978952727983707
1921,German,52,95,61,61,113,4.736198448394496,53,122,77,77,130,4.875197323201151
1921,Greek,1,25,8,4,5,1.791759469228055,1,36,15,9,10,2.3978952727983707
1921,Hungarian,1,3,0,0,1,0.6931471805599453,1,3,0,0,1,0.6931471805599453
1921,Chechen,0,9,5,11,11,2.4849066497880004,0,10,4,12,12,2.5649493574615367
1921,Chinese,3,44,37,34,37,3.6375861597263857,3,50,40,34,37,3.6375861597263857
1921,Chuvash,136,28,126,98,234,5.459585514144159,140,46,257,218,358,5.883322388488279
1921,Japanese,1,5,0,1,2,1.0986122886681098,1,7,0,3,4,1.6094379124341003
1921,Jewish,104,138,142,149,253,5.537334267018537,105,143,144,149,254,5.541263545158426
1921,Kabardian,9,0,0,0,9,2.302585092994046,9,0,0,0,9,2.302585092994046
1921,Kalmyk,0,1,0,1,1,0.6931471805599453,0,1,0,0,0,0
1921,Karelian,0,39,54,22,22,3.1354942159291497,1,49,59,13,14,2.70805020110221
1921,Kazakh,66,6,2,6,72,4.290459441148391,67,7,2,7,74,4.31748811353631
1921,Khakas,1,10,2,0,1,0.6931471805599453,1,13,2,0,1,0.6931471805599453
1921,Komi,47,14,23,15,62,4.143134726391533,142,19,32,21,163,5.099866427824199
1921,Korean,6,17,26,26,32,3.4965075614664802,6,23,36,35,41,3.7376696182833684
1921,Latvian,39,46,42,51,90,4.51085950651685,39,55,48,59,98,4.59511985013459
1921,Lithuanian,14,2,0,1,15,2.772588722239781,15,2,0,1,16,2.833213344056216
1921,Mari,2,6,18,18,20,3.044522437723423,21,8,25,21,42,3.7612001156935624
1921,Moldovan,1,3,0,0,1,0.6931471805599453,1,7,7,6,7,2.0794415416798357
1921,Mordvin,10,16,10,0,10,2.3978952727983707,10,21,13,0,10,2.3978952727983707
1921,Ossetian,7,1,0,0,7,2.0794415416798357,11,2,0,1,12,2.5649493574615367
1921,Polish,82,84,21,45,127,4.852030263919617,88,99,14,52,140,4.948759890378168
1921,Russian,5602,2398,2495,2445,8047,8.99317889233952,5996,3228,3362,3141,9137,9.120196822123217
1921,Tatar,183,27,11,24,207,5.337538079701318,188,33,11,29,217,5.384495062789089
1921,Udmurt,0,4,1,0,0,0,0,8,30,15,15,2.772588722239781
1921,Ukrainian,82,167,214,192,274,5.616771097666572,85,210,258,223,308,5.733341276897746
1921,Uzbek,1,0,0,0,1,0.6931471805599453,1,0,0,0,1,0.6931471805599453
1921,Yakut,61,15,26,18,79,4.382026634673881,85,19,31,19,104,4.653960350157523
1922,Altai,0,0,0,0,0,0,0,0,0,0,0,0
1922,Armenian,1,2,2,2,3,1.3862943611198906,1,5,5,5,6,1.9459101490553132
1922,Balkar,0,0,0,0,0,0,0,1,0,1,1,0.6931471805599453
1922,Bashkir,1,0,0,0,1,0.6931471805599453,1,0,0,0,1,0.6931471805599453
1922,Belorussian,8,35,27,35,43,3.784189633918261,8,45,33,44,52,3.970291913552122
1922,Bulgarian,1,1,0,0,1,0.6931471805599453,1,1,0,0,1,0.6931471805599453
1922,Buryat,3,3,3,4,7,2.0794415416798357,3,3,3,4,7,2.0794415416798357
1922,Estonian,1,9,8,9,10,2.3978952727983707,1,11,9,11,12,2.5649493574615367
1922,Finnish,0,4,2,2,2,1.0986122886681098,0,4,1,1,1,0.6931471805599453
1922,Georgian,0,2,1,1,1,0.6931471805599453,0,2,1,0,0,0
1922,German,10,31,23,22,32,3.4965075614664802,11,47,37,36,47,3.871201010907891
1922,Greek,0,12,10,9,9,2.302585092994046,0,14,10,9,9,2.302585092994046
1922,Hungarian,0,1,0,0,0,0,0,1,0,0,0,0
1922,Chechen,0,0,0,0,0,0,0,0,0,0,0,0
1922,Chinese,0,1,0,0,0,0,0,6,3,2,2,1.0986122886681098
1922,Chuvash,4,7,30,25,29,3.4011973816621555,10,8,27,21,31,3.4657359027997265
1922,Japanese,0,1,0,1,1,0.6931471805599453,0,2,0,1,1,0.6931471805599453
1922,Jewish,92,87,93,97,189,5.247024072160486,97,97,103,105,202,5.313205979041787
1922,Kabardian,0,0,0,0,0,0,0,0,0,0,0,0
1922,Kalmyk,1,0,0,0,1,0.6931471805599453,1,0,0,0,1,0.6931471805599453
1922,Karelian,0,10,13,7,7,2.0794415416798357,0,10,0,0,0,0
1922,Kazakh,2,1,0,1,3,1.3862943611198906,8,3,2,3,11,2.4849066497880004
1922,Khakas,1,1,0,0,1,0.6931471805599453,1,3,0,0,1,0.6931471805599453
1922,Komi,6,10,30,30,36,3.6109179126442243,27,11,32,30,57,4.060443010546419
1922,Korean,5,3,4,4,9,2.302585092994046,5,5,7,8,13,2.6390573296152584
1922,Latvian,5,6,2,4,9,2.302585092994046,6,8,3,5,11,2.4849066497880004
1922,Lithuanian,5,0,0,0,5,1.791759469228055,5,0,0,0,5,1.791759469228055
1922,Mari,0,1,2,2,2,1.0986122886681098,19,1,1,1,20,3.044522437723423
1922,Moldovan,0,2,3,4,4,1.6094379124341003,0,3,6,6,6,1.9459101490553132
1922,Mordvin,1,6,13,9,10,2.3978952727983707,1,7,12,6,7,2.0794415416798357
1922,Ossetian,1,0,0,0,1,0.6931471805599453,1,0,0,0,1,0.6931471805599453
1922,Polish,19,31,17,23,42,3.7612001156935624,21,37,17,25,46,3.8501476017100584
1922,Russian,832,589,604,589,1421,7.259819610363186,956,783,801,806,1762,7.47477218239787
1922,Tatar,13,4,0,5,18,2.9444389791664403,13,14,9,19,32,3.4965075614664802
1922,Udmurt,0,0,0,0,0,0,0,0,0,0,0,0
1922,Ukrainian,20,34,33,26,46,3.8501476017100584,21,43,39,27,48,3.8918202981106265
1922,Uzbek,0,0,0,0,0,0,0,0,0,0,0,0
1922,Yakut,18,2,0,0,18,2.9444389791664403,21,2,0,0,21,3.091042453358316
1923,Altai,0,0,0,0,0,0,0,0,0,0,0,0
1923,Armenian,1,2,2,2,3,1.3862943611198906,1,2,2,2,3,1.3862943611198906
1923,Balkar,0,0,0,0,0,0,0,0,0,0,0,0
1923,Bashkir,0,0,0,0,0,0,1,3,0,4,5,1.791759469228055
1923,Belorussian,33,14,5,9,42,3.7612001156935624,36,24,6,8,44,3.8066624897703196
1923,Bulgarian,0,0,0,0,0,0,0,0,0,0,0,0
1923,Buryat,0,0,0,0,0,0,0,0,0,0,0,0
1923,Estonian,9,6,6,5,14,2.70805020110221,11,6,4,4,15,2.772588722239781
1923,Finnish,0,4,3,3,3,1.3862943611198906,0,6,5,5,5,1.791759469228055
1923,Georgian,1,1,1,0,1,0.6931471805599453,1,1,0,0,1,0.6931471805599453
1923,German,8,26,22,21,29,3.4011973816621555,8,39,32,30,38,3.6635616461296463
1923,Greek,2,5,3,3,5,1.791759469228055,2,8,4,4,6,1.9459101490553132
1923,Hungarian,2,0,0,0,2,1.0986122886681098,2,0,0,0,2,1.0986122886681098
1923,Chechen,0,2,2,2,2,1.0986122886681098,0,3,2,3,3,1.3862943611198906
1923,Chinese,0,0,0,0,0,0,0,0,0,0,0,0
1923,Chuvash,2,1,0,0,2,1.0986122886681098,2,3,0,0,2,1.0986122886681098
1923,Japanese,1,0,0,0,1,0.6931471805599453,1,2,0,1,2,1.0986122886681098
1923,Jewish,68,103,112,117,185,5.225746673713202,80,117,126,128,208,5.342334251964811
1923,Kabardian,0,0,0,0,0,0,0,0,0,0,0,0
1923,Kalmyk,2,0,0,0,2,1.0986122886681098,2,0,0,0,2,1.0986122886681098
1923,Karelian,0,7,16,21,21,3.091042453358316,0,8,3,3,3,1.3862943611198906
1923,Kazakh,4,0,0,0,4,1.6094379124341003,5,1,0,1,6,1.9459101490553132
1923,Khakas,0,1,0,0,0,0,0,3,1,1,1,0.6931471805599453
1923,Komi,1,1,0,0,1,0.6931471805599453,10,7,19,19,29,3.4011973816621555
1923,Korean,2,1,1,1,3,1.3862943611198906,2,5,8,8,10,2.3978952727983707
1923,Latvian,3,10,11,11,14,2.70805020110221,5,13,13,14,19,2.995732273553991
1923,Lithuanian,4,2,3,3,7,2.0794415416798357,5,3,4,4,9,2.302585092994046
1923,Mari,0,0,0,0,0,0,0,0,0,0,0,0
1923,Moldovan,1,0,0,0,1,0.6931471805599453,1,0,0,0,1,0.6931471805599453
1923,Mordvin,1,1,0,0,1,0.6931471805599453,1,2,0,0,1,0.6931471805599453
1923,Ossetian,1,0,0,0,1,0.6931471805599453,1,0,0,0,1,0.6931471805599453
1923,Polish,31,30,26,30,61,4.127134385045092,34,39,27,34,68,4.23410650459726
1923,Russian,380,254,245,277,657,6.489204931325317,507,515,512,540,1047,6.954638864880987
1923,Tatar,4,0,0,0,4,1.6094379124341003,4,13,10,13,17,2.8903717578961645
1923,Udmurt,0,0,0,0,0,0,0,0,0,0,0,0
1923,Ukrainian,10,9,0,0,10,2.3978952727983707,16,43,55,55,71,4.276666119016055
1923,Uzbek,0,0,0,0,0,0,0,0,0,0,0,0
1923,Yakut,2,1,0,0,2,1.0986122886681098,2,3,3,3,5,1.791759469228055
1924,Altai,0,0,0,0,0,0,0,1,1,2,2,1.0986122886681098
1924,Armenian,1,1,1,1,2,1.0986122886681098,2,1,1,1,3,1.3862943611198906
1924,Balkar,0,0,0,0,0,0,0,0,0,0,0,0
1924,Bashkir,1,0,0,0,1,0.6931471805599453,1,6,6,7,8,2.1972245773362196
1924,Belorussian,56,15,13,16,72,4.290459441148391,60,25,7,13,73,4.30406509320417
1924,Bulgarian,0,0,0,0,0,0,0,2,3,3,3,1.3862943611198906
1924,Buryat,0,0,0,0,0,0,0,0,0,0,0,0
1924,Estonian,7,5,5,5,12,2.5649493574615367,8,11,10,10,18,2.9444389791664403
1924,Finnish,2,1,0,0,2,1.0986122886681098,2,5,3,3,5,1.791759469228055
1924,Georgian,0,0,0,0,0,0,1,0,0,0,1,0.6931471805599453
1924,German,7,11,8,6,13,2.6390573296152584,9,40,32,31,40,3.713572066704308
1924,Greek,0,2,0,0,0,0,1,10,7,6,7,2.0794415416798357
1924,Hungarian,2,0,0,0,2,1.0986122886681098,2,0,0,0,2,1.0986122886681098
1924,Chechen,0,0,0,0,0,0,0,1,0,0,0,0
1924,Chinese,1,1,0,1,2,1.0986122886681098,1,1,0,0,1,0.6931471805599453
1924,Chuvash,0,3,14,13,13,2.6390573296152584,0,6,19,13,13,2.6390573296152584
1924,Japanese,0,0,0,0,0,0,0,7,3,6,6,1.9459101490553132
1924,Jewish,70,47,51,53,123,4.820281565605037,82,60,63,65,147,4.997212273764115
1924,Kabardian,1,0,0,0,1,0.6931471805599453,2,0,0,0,2,1.0986122886681098
1924,Kalmyk,0,0,0,0,0,0,0,0,0,0,0,0
1924,Karelian,0,3,0,0,0,0,1,7,0,0,1,0.6931471805599453
1924,Kazakh,8,0,0,0,8,2.1972245773362196,10,2,1,2,12,2.5649493574615367
1924,Khakas,0,3,2,2,2,1.0986122886681098,1,5,3,3,4,1.6094379124341003
1924,Komi,7,0,0,0,7,2.0794415416798357,7,1,0,0,7,2.0794415416798357
1924,Korean,1,0,0,0,1,0.6931471805599453,1,7,12,12,13,2.6390573296152584
1924,Latvian,5,12,15,16,21,3.091042453358316,6,17,18,19,25,3.258096538021482
1924,Lithuanian,0,1,1,1,1,0.6931471805599453,0,1,0,1,1,0.6931471805599453
1924,Mari,0,0,0,0,0,0,0,4,17,17,17,2.8903717578961645
1924,Moldovan,0,0,0,0,0,0,0,0,0,0,0,0
1924,Mordvin,0,2,3,2,2,1.0986122886681098,1,3,0,0,1,0.6931471805599453
1924,Ossetian,1,0,0,0,1,0.6931471805599453,2,0,0,0,2,1.0986122886681098
1924,Polish,21,7,0,0,21,3.091042453358316,26,17,0,6,32,3.4965075614664802
1924,Russian,516,213,215,219,735,6.601230118728877,673,590,601,616,1289,7.162397497355718
1924,Tatar,2,0,0,0,2,1.0986122886681098,6,23,22,23,29,3.4011973816621555
1924,Udmurt,0,0,0,0,0,0,0,1,0,0,0,0
1924,Ukrainian,19,19,27,26,45,3.828641396489095,27,46,61,58,85,4.454347296253507
1924,Uzbek,0,0,0,0,0,0,0,0,0,0,0,0
1924,Yakut,1,1,0,0,1,0.6931471805599453,1,2,0,0,1,0.6931471805599453
1925,Altai,0,0,0,0,0,0,0,3,5,5,5,1.791759469228055
1925,Armenian,0,0,0,0,0,0,0,0,0,0,0,0
1925,Balkar,0,0,0,0,0,0,0,1,0,0,0,0
1925,Bashkir,0,0,0,0,0,0,1,8,8,9,10,2.3978952727983707
1925,Belorussian,87,10,8,12,99,4.605170185988092,89,18,0,0,89,4.499809670330265
1925,Bulgarian,0,0,0,0,0,0,0,0,0,0,0,0
1925,Buryat,1,0,0,0,1,0.6931471805599453,1,2,2,2,3,1.3862943611198906
1925,Estonian,25,6,7,8,33,3.5263605246161616,25,14,13,15,40,3.713572066704308
1925,Finnish,1,0,0,0,1,0.6931471805599453,1,1,0,0,1,0.6931471805599453
1925,Georgian,2,1,1,1,3,1.3862943611198906,2,2,1,1,3,1.3862943611198906
1925,German,3,1,0,0,3,1.3862943611198906,8,39,28,28,36,3.6109179126442243
1925,Greek,0,1,0,0,0,0,0,19,17,16,16,2.833213344056216
1925,Hungarian,4,0,0,0,4,1.6094379124341003,4,0,0,0,4,1.6094379124341003
1925,Chechen,0,0,0,0,0,0,0,4,3,5,5,1.791759469228055
1925,Chinese,1,0,0,0,1,0.6931471805599453,1,2,0,0,1,0.6931471805599453
1925,Chuvash,1,4,29,29,30,3.4339872044851463,1,7,18,11,12,2.5649493574615367
1925,Japanese,0,2,1,2,2,1.0986122886681098,0,5,0,3,3,1.3862943611198906
1925,Jewish,100,22,24,25,125,4.836281906951478,111,46,47,49,160,5.081404364984463
1925,Kabardian,2,0,0,0,2,1.0986122886681098,2,0,0,0,2,1.0986122886681098
1925,Kalmyk,0,0,0,0,0,0,1,1,1,1,2,1.0986122886681098
1925,Karelian,0,6,22,23,23,3.1780538303479458,0,10,0,0,0,0
1925,Kazakh,6,0,0,0,6,1.9459101490553132,6,5,4,5,11,2.4849066497880004
1925,Khakas,2,2,2,2,4,1.6094379124341003,2,6,4,3,5,1.791759469228055
1925,Komi,2,0,0,0,2,1.0986122886681098,2,1,0,0,2,1.0986122886681098
1925,Korean,0,2,3,4,4,1.6094379124341003,0,27,50,51,51,3.9512437185814275
1925,Latvian,3,4,4,4,7,2.0794415416798357,3,13,11,13,16,2.833213344056216
1925,Lithuanian,0,0,0,0,0,0,0,1,0,1,1,0.6931471805599453
1925,Mari,0,0,0,0,0,0,1,8,35,35,36,3.6109179126442243
1925,Moldovan,0,0,0,0,0,0,0,1,0,0,0,0
1925,Mordvin,0,2,6,4,4,1.6094379124341003,0,8,18,13,13,2.6390573296152584
1925,Ossetian,0,0,0,0,0,0,0,0,0,0,0,0
1925,Polish,24,9,5,7,31,3.4657359027997265,29,18,0,11,40,3.713572066704308
1925,Russian,339,169,175,147,486,6.18826412308259,456,830,864,906,1362,7.217443431696533
1925,Tatar,4,0,0,0,4,1.6094379124341003,11,27,25,25,36,3.6109179126442243
1925,Udmurt,0,0,0,0,0,0,0,0,0,0,0,0
1925,Ukrainian,15,4,0,0,15,2.772588722239781,16,22,0,0,16,2.833213344056216
1925,Uzbek,0,0,0,0,0,0,0,0,0,0,0,0
1925,Yakut,0,0,0,0,0,0,0,0,0,0,0,0
1926,Altai,0,0,0,0,0,0,0,9,16,17,17,2.8903717578961645
1926,Armenian,1,1,1,1,2,1.0986122886681098,3,2,1,1,4,1.6094379124341003
1926,Balkar,1,0,0,0,1,0.6931471805599453,1,2,0,1,2,1.0986122886681098
1926,Bashkir,0,0,0,0,0,0,0,21,27,30,30,3.4339872044851463
1926,Belorussian,75,20,26,28,103,4.6443908991413725,78,31,0,0,78,4.3694478524670215
1926,Bulgarian,0,0,0,0,0,0,0,1,0,0,0,0
1926,Buryat,0,0,0,0,0,0,0,5,5,5,5,1.791759469228055
1926,Estonian,2,12,15,15,17,2.8903717578961645,2,27,25,29,31,3.4657359027997265
1926,Finnish,1,3,3,3,4,1.6094379124341003,1,11,7,8,9,2.302585092994046
1926,Georgian,4,1,1,1,5,1.791759469228055,5,4,2,2,7,2.0794415416798357
1926,German,3,6,3,1,4,1.6094379124341003,9,81,61,61,70,4.2626798770413155
1926,Greek,0,1,0,0,0,0,0,27,20,18,18,2.9444389791664403
1926,Hungarian,1,0,0,0,1,0.6931471805599453,1,0,0,0,1,0.6931471805599453
1926,Chechen,0,0,0,0,0,0,0,5,2,4,4,1.6094379124341003
1926,Chinese,13,0,0,0,13,2.6390573296152584,14,3,0,0,14,2.70805020110221
1926,Chuvash,11,4,27,26,37,3.6375861597263857,13,15,51,34,47,3.871201010907891
1926,Japanese,0,0,0,0,0,0,0,9,0,5,5,1.791759469228055
1926,Jewish,82,16,17,18,100,4.61512051684126,102,48,46,48,150,5.017279836814924
1926,Kabardian,5,0,0,0,5,1.791759469228055,6,4,2,4,10,2.3978952727983707
1926,Kalmyk,0,0,0,0,0,0,0,0,0,0,0,0
1926,Karelian,0,3,3,0,0,0,0,8,0,0,0,0
1926,Kazakh,33,1,1,1,34,3.5553480614894135,36,6,4,3,39,3.6888794541139363
1926,Khakas,0,0,0,0,0,0,2,14,10,8,10,2.3978952727983707
1926,Komi,1,1,1,1,2,1.0986122886681098,2,4,0,0,2,1.0986122886681098
1926,Korean,1,0,0,0,1,0.6931471805599453,1,64,118,122,123,4.820281565605037
1926,Latvian,3,9,11,10,13,2.6390573296152584,4,17,9,13,17,2.8903717578961645
1926,Lithuanian,2,0,0,0,2,1.0986122886681098,2,2,0,2,4,1.6094379124341003
1926,Mari,0,0,0,0,0,0,2,18,80,80,82,4.418840607796598
1926,Moldovan,1,0,0,0,1,0.6931471805599453,1,1,0,0,1,0.6931471805599453
1926,Mordvin,2,3,10,9,11,2.4849066497880004,3,10,5,0,3,1.3862943611198906
1926,Ossetian,1,2,2,2,3,1.3862943611198906,4,4,3,4,8,2.1972245773362196
1926,Polish,12,11,7,5,17,2.8903717578961645,15,27,0,13,28,3.367295829986474
1926,Russian,371,177,178,156,527,6.269096283706261,528,1579,1644,1711,2239,7.7142311448490855
1926,Tatar,10,1,0,1,11,2.4849066497880004,21,51,47,39,60,4.110873864173311
1926,Udmurt,1,0,0,0,1,0.6931471805599453,1,4,15,8,9,2.302585092994046
1926,Ukrainian,22,15,20,19,41,3.7376696182833684,26,71,51,39,65,4.189654742026425
1926,Uzbek,1,0,0,0,1,0.6931471805599453,1,1,0,0,1,0.6931471805599453
1926,Yakut,0,1,1,0,0,0,0,2,0,0,0,0
1927,Altai,9,0,0,0,9,2.302585092994046,12,9,14,15,27,3.332204510175204
1927,Armenian,4,1,1,1,5,1.791759469228055,6,5,3,4,10,2.3978952727983707
1927,Balkar,2,0,0,0,2,1.0986122886681098,2,7,3,4,6,1.9459101490553132
1927,Bashkir,0,2,0,2,2,1.0986122886681098,1,37,47,42,43,3.784189633918261
1927,Belorussian,207,21,11,16,223,5.4116460518550396,232,59,0,0,232,5.4510384535657
1927,Bulgarian,1,0,0,0,1,0.6931471805599453,1,4,0,0,1,0.6931471805599453
1927,Buryat,1,1,1,1,2,1.0986122886681098,1,8,8,9,10,2.3978952727983707
1927,Estonian,18,37,47,49,67,4.219507705176107,20,49,45,52,72,4.290459441148391
1927,Finnish,1,3,2,0,1,0.6931471805599453,2,20,11,13,15,2.772588722239781
1927,Georgian,5,4,5,6,11,2.4849066497880004,7,6,1,1,8,2.1972245773362196
1927,German,15,19,13,9,24,3.2188758248682006,30,197,163,166,196,5.2832037287379885
1927,Greek,0,7,5,4,4,1.6094379124341003,0,63,55,50,50,3.9318256327243257
1927,Hungarian,3,2,2,3,6,1.9459101490553132,3,2,0,0,3,1.3862943611198906
1927,Chechen,0,0,0,0,0,0,0,6,0,2,2,1.0986122886681098
1927,Chinese,28,0,0,0,28,3.367295829986474,30,9,0,0,30,3.4339872044851463
1927,Chuvash,20,3,1,0,20,3.044522437723423,23,14,0,0,23,3.1780538303479458
1927,Japanese,1,5,2,2,3,1.3862943611198906,2,26,10,16,18,2.9444389791664403
1927,Jewish,66,9,8,8,74,4.31748811353631,77,76,72,75,152,5.030437921392435
1927,Kabardian,8,2,2,2,10,2.3978952727983707,11,16,14,16,27,3.332204510175204
1927,Kalmyk,0,0,0,0,0,0,0,2,1,2,2,1.0986122886681098
1927,Karelian,1,13,43,41,42,3.7612001156935624,1,31,0,0,1,0.6931471805599453
1927,Kazakh,22,18,20,18,40,3.713572066704308,26,37,36,33,59,4.0943445622221
1927,Khakas,3,2,0,0,3,1.3862943611198906,8,16,6,4,12,2.5649493574615367
1927,Komi,6,0,0,0,6,1.9459101490553132,6,9,0,0,6,1.9459101490553132
1927,Korean,11,0,0,0,11,2.4849066497880004,11,75,136,140,151,5.0238805208462765
1927,Latvian,15,15,17,13,28,3.367295829986474,16,26,9,15,31,3.4657359027997265
1927,Lithuanian,9,3,4,4,13,2.6390573296152584,9,4,0,5,14,2.70805020110221
1927,Mari,1,1,3,3,4,1.6094379124341003,9,28,122,125,134,4.90527477843843
1927,Moldovan,0,0,0,0,0,0,0,5,2,3,3,1.3862943611198906
1927,Mordvin,0,2,0,0,0,0,2,25,44,25,27,3.332204510175204
1927,Ossetian,9,0,0,0,9,2.302585092994046,14,1,0,0,14,2.70805020110221
1927,Polish,51,27,18,22,73,4.30406509320417,69,78,0,58,127,4.852030263919617
1927,Russian,1115,407,413,407,1522,7.328437352895162,1503,2895,2996,3157,4660,8.446985296372741
1927,Tatar,12,9,7,8,20,3.044522437723423,26,132,130,124,150,5.017279836814924
1927,Udmurt,0,1,3,2,2,1.0986122886681098,0,8,34,23,23,3.1780538303479458
1927,Ukrainian,56,23,20,20,76,4.343805421853684,78,127,80,56,134,4.90527477843843
1927,Uzbek,8,3,7,8,16,2.833213344056216,8,5,3,8,16,2.833213344056216
1927,Yakut,57,3,6,5,62,4.143134726391533,59,5,0,0,59,4.0943445622221
1928,Altai,2,2,3,4,6,1.9459101490553132,7,8,9,11,18,2.9444389791664403
1928,Armenian,3,2,2,2,5,1.791759469228055,4,14,12,13,17,2.8903717578961645
1928,Balkar,7,0,0,0,7,2.0794415416798357,7,20,13,13,20,3.044522437723423
1928,Bashkir,14,1,0,1,15,2.772588722239781,16,73,96,52,68,4.23410650459726
1928,Belorussian,259,22,16,18,277,5.627621113690637,300,133,0,0,300,5.707110264748875
1928,Bulgarian,1,1,1,1,2,1.0986122886681098,1,11,9,5,6,1.9459101490553132
1928,Buryat,3,2,2,2,5,1.791759469228055,3,9,9,9,12,2.5649493574615367
1928,Estonian,8,9,9,10,18,2.9444389791664403,11,35,8,23,34,3.5553480614894135
1928,Finnish,5,5,4,5,10,2.3978952727983707,5,39,24,31,36,3.6109179126442243
1928,Georgian,1,1,0,0,1,0.6931471805599453,5,8,0,0,5,1.791759469228055
1928,German,12,12,6,4,16,2.833213344056216,41,331,267,281,322,5.777652323222656
1928,Greek,1,5,2,2,3,1.3862943611198906,3,142,136,127,130,4.875197323201151
1928,Hungarian,4,1,0,1,5,1.791759469228055,5,2,0,0,5,1.791759469228055
1928,Chechen,0,0,0,0,0,0,0,22,14,21,21,3.091042453358316
1928,Chinese,14,0,0,0,14,2.70805020110221,14,15,0,0,14,2.70805020110221
1928,Chuvash,29,1,0,0,29,3.4011973816621555,33,40,60,0,33,3.5263605246161616
1928,Japanese,0,4,2,3,3,1.3862943611198906,0,25,0,11,11,2.4849066497880004
1928,Jewish,71,22,23,24,95,4.564348191467836,95,47,30,34,129,4.867534450455582
1928,Kabardian,160,1,1,1,161,5.087596335232384,168,24,19,23,191,5.2574953720277815
1928,Kalmyk,0,0,0,0,0,0,1,1,0,0,1,0.6931471805599453
1928,Karelian,0,1,0,0,0,0,1,31,0,0,1,0.6931471805599453
1928,Kazakh,151,4,4,3,154,5.043425116919247,170,29,22,16,186,5.231108616854587
1928,Khakas,0,1,0,0,0,0,7,65,52,47,54,4.007333185232471
1928,Komi,8,5,14,14,22,3.1354942159291497,8,22,15,0,8,2.1972245773362196
1928,Korean,3,1,1,1,4,1.6094379124341003,5,72,124,127,132,4.890349128221754
1928,Latvian,26,11,12,13,39,3.6888794541139363,27,26,0,5,32,3.4965075614664802
1928,Lithuanian,3,2,2,3,6,1.9459101490553132,3,2,0,0,3,1.3862943611198906
1928,Mari,2,3,13,14,16,2.833213344056216,19,38,160,159,178,5.187385805840755
1928,Moldovan,0,1,1,1,1,0.6931471805599453,0,9,3,1,1,0.6931471805599453
1928,Mordvin,8,1,0,0,8,2.1972245773362196,20,73,233,191,211,5.356586274672012
1928,Ossetian,7,0,0,0,7,2.0794415416798357,29,10,7,9,38,3.6635616461296463
1928,Polish,50,23,15,18,68,4.23410650459726,116,98,0,43,159,5.075173815233827
1928,Russian,1438,399,414,462,1900,7.550135342488429,2303,5319,5509,5702,8005,8.987946539552519
1928,Tatar,139,2,0,1,140,4.948759890378168,203,396,420,428,631,6.448889394146858
1928,Udmurt,4,1,4,3,7,2.0794415416798357,7,12,34,7,14,2.70805020110221
1928,Ukrainian,85,25,29,21,106,4.672828834461906,130,327,370,320,450,6.111467339502679
1928,Uzbek,8,1,1,3,11,2.4849066497880004,8,7,0,7,15,2.772588722239781
1928,Yakut,168,2,2,1,169,5.135798437050262,183,10,0,0,183,5.214935757608986
1929,Altai,8,1,0,0,8,2.1972245773362196,38,27,22,32,70,4.2626798770413155
1929,Armenian,18,0,0,0,18,2.9444389791664403,25,32,16,18,43,3.784189633918261
1929,Balkar,11,0,0,0,11,2.4849066497880004,14,80,47,49,63,4.1588830833596715
1929,Bashkir,293,4,0,0,293,5.683579767338681,305,429,609,424,729,6.593044534142437
1929,Belorussian,1898,91,0,30,1928,7.564757012905729,2192,730,0,0,2192,7.693025748417888
1929,Bulgarian,2,0,0,0,2,1.0986122886681098,2,55,45,24,26,3.295836866004329
1929,Buryat,52,3,2,3,55,4.02535169073515,54,25,19,22,76,4.343805421853684
1929,Estonian,40,26,15,23,63,4.1588830833596715,47,97,0,13,60,4.110873864173311
1929,Finnish,1,20,12,13,14,2.70805020110221,3,148,65,92,95,4.564348191467836
1929,Georgian,2,2,0,0,2,1.0986122886681098,2,37,0,0,2,1.0986122886681098
1929,German,205,110,71,77,282,5.645446897643238,309,1474,1144,1231,1540,7.340186835320115
1929,Greek,7,17,0,0,7,2.0794415416798357,10,733,716,679,689,6.536691597591305
1929,Hungarian,0,0,0,0,0,0,0,3,0,0,0,0
1929,Chechen,0,13,10,19,19,2.995732273553991,0,118,87,124,124,4.8283137373023015
1929,Chinese,72,9,0,13,85,4.454347296253507,75,32,0,0,75,4.330733340286331
1929,Chuvash,360,27,92,65,425,6.054439346269371,393,318,1496,1092,1485,7.303843225277705
1929,Japanese,0,41,25,28,28,3.367295829986474,0,195,48,121,121,4.804021044733257
1929,Jewish,122,32,24,28,150,5.017279836814924,169,97,1,22,191,5.2574953720277815
1929,Kabardian,104,5,2,5,109,4.700480365792417,112,92,67,88,200,5.303304908059076
1929,Kalmyk,0,1,0,1,1,0.6931471805599453,2,6,0,1,3,1.3862943611198906
1929,Karelian,3,49,85,57,60,4.110873864173311,4,266,0,0,4,1.6094379124341003
1929,Kazakh,712,43,44,26,738,6.6052979209482015,794,173,144,100,894,6.796823718274855
1929,Khakas,6,13,3,1,7,2.0794415416798357,88,275,206,181,269,5.598421958998375
1929,Komi,60,14,18,8,68,4.23410650459726,61,100,44,0,61,4.127134385045092
1929,Korean,4,0,0,0,4,1.6094379124341003,5,232,375,386,391,5.971261839790462
1929,Latvian,125,28,13,24,149,5.0106352940962555,140,141,0,60,200,5.303304908059076
1929,Lithuanian,25,2,0,1,26,3.295836866004329,33,10,0,3,36,3.6109179126442243
1929,Mari,60,1,0,0,60,4.110873864173311,158,110,416,374,532,6.278521424165844
1929,Moldovan,2,0,0,0,2,1.0986122886681098,4,32,0,0,4,1.6094379124341003
1929,Mordvin,167,34,99,76,243,5.497168225293202,202,380,1265,1017,1219,7.106606137727303
1929,Ossetian,13,0,0,0,13,2.6390573296152584,156,23,7,13,169,5.135798437050262
1929,Polish,630,97,25,77,707,6.56244409369372,1039,512,0,222,1261,7.140453043101158
1929,Russian,9562,3042,3226,3208,12770,9.454932254496262,13892,26103,27027,26329,40221,10.602169388594548
1929,Tatar,1030,37,19,34,1064,6.970730078143525,1315,1971,2091,2034,3349,8.116715624819111
1929,Udmurt,62,8,36,26,88,4.48863636973214,73,63,210,61,134,4.90527477843843
1929,Ukrainian,763,140,121,90,853,6.74993119378857,1004,1889,2483,2318,3322,8.108623268354595
1929,Uzbek,23,20,46,56,79,4.382026634673881,23,51,41,82,105,4.663439094112067
1929,Yakut,118,6,0,0,118,4.77912349311153,118,38,0,0,118,4.77912349311153
1930,Altai,106,7,2,5,111,4.718498871295094,190,102,67,106,296,5.6937321388027
1930,Armenian,31,18,13,16,47,3.871201010907891,36,145,79,80,116,4.762173934797756
1930,Balkar,98,11,0,1,99,4.605170185988092,101,314,176,192,293,5.683579767338681
1930,Bashkir,1398,74,56,86,1484,7.3031700512368,1461,2084,3107,2215,3676,8.209852481301272
1930,Belorussian,3503,393,118,286,3789,8.240121298076472,3674,3259,0,94,3768,8.234564993267135
1930,Bulgarian,8,6,0,0,8,2.1972245773362196,8,239,207,84,92,4.532599493153256
1930,Buryat,470,14,13,14,484,6.184148890937483,477,106,80,95,572,6.35088571671474
1930,Estonian,212,77,31,64,276,5.6240175061873385,230,405,0,38,268,5.594711379601839
1930,Finnish,8,39,4,8,16,2.833213344056216,15,826,515,656,671,6.5102583405231496
1930,Georgian,12,17,0,4,16,2.833213344056216,25,226,52,9,34,3.5553480614894135
1930,German,475,405,268,299,774,6.652863029353347,889,6929,5596,5975,6864,8.834191318202071
1930,Greek,9,67,0,0,9,2.302585092994046,15,3636,3758,3607,3622,8.195057690895077
1930,Hungarian,7,7,0,0,7,2.0794415416798357,7,27,0,0,7,2.0794415416798357
1930,Chechen,0,53,47,69,69,4.248495242049359,0,501,370,505,505,6.226536669287466
1930,Chinese,27,6,0,5,32,3.4965075614664802,31,56,0,0,31,3.4657359027997265
1930,Chuvash,820,117,539,475,1295,7.16703787691222,932,1234,5219,3545,4477,8.4069317971587
1930,Japanese,1,197,140,121,122,4.812184355372417,1,819,196,469,470,6.154858094016418
1930,Jewish,289,122,95,108,397,5.986452005284438,312,413,5,79,391,5.971261839790462
1930,Kabardian,444,2,0,0,444,6.09807428216624,450,255,140,223,673,6.513230110912307
1930,Kalmyk,0,7,5,6,6,1.9459101490553132,6,36,6,16,22,3.1354942159291497
1930,Karelian,31,159,217,132,163,5.099866427824199,31,843,0,0,31,3.4657359027997265
1930,Kazakh,4718,321,350,237,4955,8.508354242749032,5064,958,870,623,5687,8.646113971483077
1930,Khakas,42,33,0,0,42,3.7612001156935624,460,1412,1156,1054,1514,7.323170717943469
1930,Komi,225,49,61,31,256,5.54907608489522,230,374,0,0,230,5.442417710521793
1930,Korean,13,10,0,0,13,2.6390573296152584,13,846,1325,1365,1378,7.229113877793302
1930,Latvian,485,72,7,48,533,6.280395838960195,508,444,0,6,514,6.244166900663736
1930,Lithuanian,51,6,0,3,54,4.007333185232471,53,70,0,56,109,4.700480365792417
1930,Mari,216,6,0,0,216,5.37989735354046,463,439,1630,1469,1932,7.566828479208331
1930,Moldovan,6,11,0,0,6,1.9459101490553132,7,170,1,0,7,2.0794415416798357
1930,Mordvin,585,92,190,103,688,6.535241271013659,652,1517,4837,3827,4479,8.40737832540903
1930,Ossetian,65,4,0,0,65,4.189654742026425,353,76,4,28,381,5.945420608606575
1930,Polish,1094,271,0,153,1247,7.129297548929373,1158,2441,0,1197,2355,7.764720544771477
1930,Russian,34101,10368,10910,10937,45038,10.715284060080414,47237,107829,111041,110567,157804,11.969115372570004
1930,Tatar,4288,288,254,233,4521,8.416709652837914,5353,9031,9661,9161,14514,9.58293787645873
1930,Udmurt,204,16,0,0,204,5.3230099791384085,230,303,1268,678,908,6.812345094177479
1930,Ukrainian,1887,476,381,267,2154,7.675546002537848,2864,8270,11156,10418,13282,9.494240301132503
1930,Uzbek,241,117,298,323,564,6.336825731146441,241,262,305,454,695,6.54534966033442
1930,Yakut,190,23,0,0,190,5.25227342804663,196,180,0,0,196,5.2832037287379885
1931,Altai,89,10,12,13,102,4.634728988229636,136,134,78,130,266,5.58724865840025
1931,Armenian,27,10,6,8,35,3.58351893845611,31,126,20,20,51,3.9512437185814275
1931,Balkar,102,9,1,0,102,4.634728988229636,104,441,250,256,360,5.8888779583328805
1931,Bashkir,1864,54,46,43,1907,7.553810852008231,2102,4006,6516,4529,6631,8.79966169681513
1931,Belorussian,1512,224,0,134,1646,7.4067107301776405,1622,3229,0,0,1622,7.392031567514591
1931,Bulgarian,4,4,0,0,4,1.6094379124341003,4,363,361,210,214,5.3706380281276624
1931,Buryat,265,19,20,21,286,5.659482215759621,267,190,163,183,450,6.111467339502679
1931,Estonian,129,65,39,62,191,5.2574953720277815,150,568,0,100,250,5.5254529391317835
1931,Finnish,8,22,0,1,9,2.302585092994046,27,1168,740,973,1e3,6.90875477931522
1931,Georgian,29,17,9,11,40,3.713572066704308,52,330,99,60,112,4.727387818712341
1931,German,183,295,205,228,411,6.021023349349527,309,9276,7392,7970,8279,9.021598247379305
1931,Greek,12,85,45,38,50,3.9318256327243257,12,5137,5337,5160,5172,8.551208070003515
1931,Hungarian,5,6,0,0,5,1.791759469228055,5,31,0,0,5,1.791759469228055
1931,Chechen,1,58,68,76,77,4.356708826689592,1,820,714,822,823,6.714170529909472
1931,Chinese,39,3,0,3,42,3.7612001156935624,63,76,0,0,63,4.1588830833596715
1931,Chuvash,839,47,47,7,846,6.741700694652055,1009,1661,6724,4986,5995,8.698847859222488
1931,Japanese,0,187,148,90,90,4.51085950651685,0,1184,318,700,700,6.55250788703459
1931,Jewish,284,83,65,74,358,5.883322388488279,315,400,0,0,315,5.755742213586912
1931,Kabardian,286,7,0,3,289,5.66988092298052,294,239,70,171,465,6.1441856341256456
1931,Kalmyk,2,5,4,4,6,1.9459101490553132,3,64,24,34,37,3.6375861597263857
1931,Karelian,91,98,95,63,154,5.043425116919247,92,962,0,0,92,4.532599493153256
1931,Kazakh,5969,381,426,257,6226,8.736649954872451,6229,866,675,235,6464,8.774158291205957
1931,Khakas,125,34,12,7,132,4.890349128221754,351,2128,1796,1674,2025,7.613818684808629
1931,Komi,177,34,45,30,207,5.337538079701318,178,543,88,0,178,5.187385805840755
1931,Korean,51,5,0,0,51,3.9512437185814275,58,1392,2255,2327,2385,7.777373602657861
1931,Latvian,114,51,8,35,149,5.0106352940962555,144,479,0,0,144,4.976733742420574
1931,Lithuanian,40,2,0,0,40,3.713572066704308,41,59,0,30,71,4.276666119016055
1931,Mari,474,8,9,3,477,6.169610732491456,760,750,2943,2687,3447,8.145549631783584
1931,Moldovan,13,9,0,1,14,2.70805020110221,17,254,61,4,21,3.091042453358316
1931,Mordvin,591,52,72,32,623,6.436150368369428,664,1971,5952,4766,5430,8.599878558034845
1931,Ossetian,47,2,0,0,47,3.871201010907891,183,46,0,0,183,5.214935757608986
1931,Polish,475,118,0,34,509,6.234410725718371,533,2326,0,916,1449,7.27931883541462
1931,Russian,24688,6616,6887,7222,31910,10.370706056919774,33578,150894,155649,157957,191535,12.16283105949115
1931,Tatar,4791,265,255,212,5003,8.517992871586802,5989,16470,18038,16541,22530,10.022647417705386
1931,Udmurt,122,10,0,0,122,4.812184355372417,133,423,1783,1019,1152,7.050122520269059
1931,Ukrainian,1376,300,209,152,1528,7.332369205929062,1721,8557,8573,7688,9409,9.149528232579426
1931,Uzbek,52,159,432,448,500,6.2166061010848646,52,361,415,552,604,6.405228458030842
1931,Yakut,92,29,12,4,96,4.574710978503383,100,234,0,0,100,4.61512051684126
1932,Altai,16,3,0,0,16,2.833213344056216,33,43,57,63,96,4.574710978503383
1932,Armenian,64,6,2,4,68,4.23410650459726,72,30,16,18,90,4.51085950651685
1932,Balkar,32,5,0,0,32,3.4965075614664802,33,78,49,42,75,4.330733340286331
1932,Bashkir,385,29,6,16,401,5.996452088619021,408,567,912,645,1053,6.960347729101308
1932,Belorussian,5509,155,0,34,5543,8.620471540869739,5667,553,0,0,5667,8.64259160081057
1932,Bulgarian,5,5,0,0,5,1.791759469228055,5,43,28,14,19,2.995732273553991
1932,Buryat,177,10,10,10,187,5.236441962829949,178,90,100,102,280,5.638354669333745
1932,Estonian,104,44,17,38,142,4.962844630259907,107,151,33,114,221,5.402677381872279
1932,Finnish,34,17,0,0,34,3.5553480614894135,38,104,26,51,89,4.499809670330265
1932,Georgian,36,11,2,4,40,3.713572066704308,48,38,0,0,48,3.8918202981106265
1932,German,201,122,32,47,248,5.517452896464707,229,969,650,731,960,6.8679744089702925
1932,Greek,4,49,6,0,4,1.6094379124341003,6,511,450,426,432,6.07073772800249
1932,Hungarian,7,5,0,0,7,2.0794415416798357,7,14,0,0,7,2.0794415416798357
1932,Chechen,1,37,38,46,47,3.871201010907891,1,163,172,180,181,5.204006687076795
1932,Chinese,169,7,0,5,174,5.1647859739235145,194,29,0,0,194,5.272999558563747
1932,Chuvash,651,54,179,144,795,6.679599185844383,689,250,1031,686,1375,7.226936018493289
1932,Japanese,5,173,139,90,95,4.564348191467836,5,330,198,181,186,5.231108616854587
1932,Jewish,202,73,58,67,269,5.598421958998375,235,119,38,60,295,5.69035945432406
1932,Kabardian,116,2,0,0,116,4.762173934797756,119,59,36,49,168,5.1298987149230735
1932,Kalmyk,4,1,0,0,4,1.6094379124341003,4,5,0,0,4,1.6094379124341003
1932,Karelian,55,99,170,138,193,5.267858159063328,57,220,0,0,57,4.060443010546419
1932,Kazakh,1670,356,399,254,1924,7.562681246721884,1749,439,457,256,2005,7.603897968521881
1932,Khakas,0,19,0,0,0,0,26,192,125,106,132,4.890349128221754
1932,Komi,152,33,54,39,191,5.2574953720277815,154,87,37,0,154,5.043425116919247
1932,Korean,81,7,0,0,81,4.406719247264253,91,246,410,422,513,6.2422232654551655
1932,Latvian,120,47,12,40,160,5.081404364984463,128,101,0,20,148,5.003946305945459
1932,Lithuanian,24,3,0,1,25,3.258096538021482,27,10,0,5,32,3.4965075614664802
1932,Mari,96,6,4,0,96,4.574710978503383,353,158,662,622,975,6.883462586413092
1932,Moldovan,7,6,0,0,7,2.0794415416798357,11,25,0,0,11,2.4849066497880004
1932,Mordvin,357,47,76,33,390,5.968707559985366,391,309,975,788,1179,7.07326971745971
1932,Ossetian,37,3,0,0,37,3.6375861597263857,81,24,10,13,94,4.553876891600541
1932,Polish,739,99,0,41,780,6.660575149839686,803,377,0,138,941,6.848005274576363
1932,Russian,18079,5884,6180,6262,24341,10.099958532434503,21547,21886,22454,21986,43533,10.681297520974782
1932,Tatar,1780,152,130,100,1880,7.53955882930103,2073,2237,2433,2154,4227,8.349484346990128
1932,Udmurt,148,11,19,2,150,5.017279836814924,161,57,204,75,236,5.4680601411351315
1932,Ukrainian,901,265,200,157,1058,6.9650803456014065,1098,1681,2242,2203,3301,8.102283624480073
1932,Uzbek,35,140,381,396,431,6.068425588244111,35,172,402,411,446,6.102558594613569
1932,Yakut,85,16,0,0,85,4.454347296253507,97,49,0,0,97,4.584967478670572
1933,Altai,118,2,0,0,118,4.77912349311153,124,32,24,36,160,5.081404364984463
1933,Armenian,72,9,6,7,79,4.382026634673881,96,80,68,69,165,5.111987788356544
1933,Balkar,28,6,0,1,29,3.4011973816621555,30,84,44,46,76,4.343805421853684
1933,Bashkir,609,34,14,42,651,6.480044561926653,615,446,584,650,1265,7.143617602704121
1933,Belorussian,5652,231,68,149,5801,8.665957964681349,5777,1022,0,78,5855,8.675222055641148
1933,Bulgarian,3,5,0,0,3,1.3862943611198906,3,80,84,46,49,3.912023005428146
1933,Buryat,320,4,2,3,323,5.780743515792329,322,234,272,279,601,6.400257445308821
1933,Estonian,283,132,136,157,440,6.089044875446846,298,241,83,161,459,6.131226489483141
1933,Finnish,89,28,9,8,97,4.584967478670572,93,256,167,198,291,5.676753802268282
1933,Georgian,182,21,18,21,203,5.318119993844216,228,85,46,31,259,5.560681631015528
1933,German,288,184,97,101,389,5.966146739123692,348,2390,2032,2115,2463,7.80954132465341
1933,Greek,7,48,3,0,7,2.0794415416798357,9,1003,1015,955,964,6.872128101338986
1933,Hungarian,3,7,0,1,4,1.6094379124341003,3,16,0,0,3,1.3862943611198906
1933,Chechen,11,20,9,22,33,3.5263605246161616,13,184,168,228,241,5.488937726156687
1933,Chinese,63,10,0,12,75,4.330733340286331,81,37,0,0,81,4.406719247264253
1933,Chuvash,353,90,527,478,831,6.723832440821209,367,372,1627,1066,1433,7.2682230211595655
1933,Japanese,6,98,65,53,59,4.0943445622221,6,250,67,134,140,4.948759890378168
1933,Jewish,321,61,44,50,371,5.918893854273146,379,170,55,71,450,6.111467339502679
1933,Kabardian,93,2,0,0,93,4.543294782270004,95,93,60,87,182,5.209486152841421
1933,Kalmyk,0,1,0,0,0,0,0,28,21,21,21,3.091042453358316
1933,Karelian,71,96,140,64,135,4.912654885736052,77,286,0,0,77,4.356708826689592
1933,Kazakh,1656,213,234,169,1825,7.509883061154913,1889,300,277,196,2085,7.643003635560718
1933,Khakas,102,51,34,30,132,4.890349128221754,133,432,359,325,458,6.129050210060545
1933,Komi,162,45,98,78,240,5.484796933490655,168,122,46,0,168,5.1298987149230735
1933,Korean,66,4,0,0,66,4.204692619390966,67,235,363,371,438,6.0844994130751715
1933,Latvian,225,78,55,68,293,5.683579767338681,238,213,0,89,327,5.793013608384144
1933,Lithuanian,53,5,0,5,58,4.07753744390572,58,17,0,8,66,4.204692619390966
1933,Mari,99,6,3,0,99,4.605170185988092,229,112,397,358,587,6.376726947898627
1933,Moldovan,10,4,0,0,10,2.3978952727983707,15,61,37,0,15,2.772588722239781
1933,Mordvin,362,53,104,44,406,6.008813185442595,388,421,1282,949,1337,7.198931240688173
1933,Ossetian,59,7,4,5,64,4.174387269895637,126,27,7,11,137,4.927253685157205
1933,Polish,1263,103,0,9,1272,7.149131598557407,1359,748,0,348,1707,7.443078374348516
1933,Russian,23593,5962,6239,5881,29474,10.291297725405572,27037,31972,32991,32602,59639,10.996081768878675
1933,Tatar,1027,119,90,80,1107,7.010311867307229,1159,1226,1159,978,2137,7.6676260915849905
1933,Udmurt,234,8,0,0,234,5.459585514144159,244,88,362,186,430,6.066108090103747
1933,Ukrainian,1819,398,503,476,2295,7.738923757439457,2160,2611,3706,3445,5605,8.631592731724734
1933,Uzbek,49,70,178,194,243,5.497168225293202,49,100,156,226,275,5.62040086571715
1933,Yakut,43,32,42,24,67,4.219507705176107,47,74,0,0,47,3.871201010907891
1934,Altai,45,0,0,0,45,3.828641396489095,47,18,27,29,76,4.343805421853684
1934,Armenian,19,5,5,5,24,3.2188758248682006,36,14,11,11,47,3.871201010907891
1934,Balkar,15,1,0,0,15,2.772588722239781,15,209,195,179,194,5.272999558563747
1934,Bashkir,77,4,0,2,79,4.382026634673881,81,130,192,143,224,5.41610040220442
1934,Belorussian,442,51,19,37,479,6.173786103901937,494,186,0,19,513,6.2422232654551655
1934,Bulgarian,10,2,1,1,11,2.4849066497880004,10,9,0,0,10,2.3978952727983707
1934,Buryat,119,2,2,2,121,4.804021044733257,120,32,36,35,155,5.049856007249537
1934,Estonian,49,13,9,10,59,4.0943445622221,59,133,127,147,206,5.332718793265369
1934,Finnish,23,6,2,2,25,3.258096538021482,26,52,32,39,65,4.189654742026425
1934,Georgian,16,3,1,2,18,2.9444389791664403,19,13,1,1,20,3.044522437723423
1934,German,563,135,127,131,694,6.543911845564792,621,532,454,473,1094,6.9985096422506015
1934,Greek,6,13,5,2,8,2.1972245773362196,7,150,127,126,133,4.897839799950911
1934,Hungarian,5,0,0,0,5,1.791759469228055,6,4,0,0,6,1.9459101490553132
1934,Chechen,0,1,0,0,0,0,0,130,181,185,185,5.225746673713202
1934,Chinese,43,5,1,5,48,3.8918202981106265,47,31,5,0,47,3.871201010907891
1934,Chuvash,67,10,22,17,84,4.442651256490317,80,63,171,152,232,5.4510384535657
1934,Japanese,0,13,6,8,8,2.1972245773362196,0,318,273,257,257,5.552959584921617
1934,Jewish,156,43,42,45,201,5.308267697401205,193,84,63,70,263,5.575949103146316
1934,Kabardian,3,1,0,1,4,1.6094379124341003,3,122,122,122,125,4.836281906951478
1934,Kalmyk,0,0,0,0,0,0,0,13,12,11,11,2.4849066497880004
1934,Karelian,11,18,17,10,21,3.091042453358316,12,53,0,0,12,2.5649493574615367
1934,Kazakh,253,21,22,15,268,5.594711379601839,263,142,148,84,347,5.8522024797744745
1934,Khakas,15,8,4,3,18,2.9444389791664403,42,50,28,25,67,4.219507705176107
1934,Komi,54,7,11,9,63,4.1588830833596715,55,12,0,0,55,4.02535169073515
1934,Korean,41,2,1,1,42,3.7612001156935624,45,93,159,161,206,5.332718793265369
1934,Latvian,42,19,15,19,61,4.127134385045092,49,63,20,33,82,4.418840607796598
1934,Lithuanian,6,1,0,1,7,2.0794415416798357,8,1,0,0,8,2.1972245773362196
1934,Mari,36,0,0,0,36,3.6109179126442243,78,38,152,146,224,5.41610040220442
1934,Moldovan,4,1,0,0,4,1.6094379124341003,7,10,0,0,7,2.0794415416798357
1934,Mordvin,46,4,0,0,46,3.8501476017100584,55,57,82,57,112,4.727387818712341
1934,Ossetian,26,1,0,1,27,3.332204510175204,44,23,21,19,63,4.1588830833596715
1934,Polish,134,28,0,8,142,4.962844630259907,190,187,0,127,317,5.762051382780177
1934,Russian,4396,1201,1246,1313,5709,8.649974302650056,5182,6206,6217,6625,11807,9.376532546840254
1934,Tatar,193,26,20,26,219,5.393627546352362,260,521,551,488,748,6.618738983517219
1934,Udmurt,19,2,0,0,19,2.995732273553991,30,9,0,0,30,3.4339872044851463
1934,Ukrainian,413,71,76,65,478,6.171700597410915,501,366,323,330,831,6.723832440821209
1934,Uzbek,6,8,18,22,28,3.367295829986474,6,55,129,126,132,4.890349128221754
1934,Yakut,3,3,0,0,3,1.3862943611198906,5,17,0,0,5,1.791759469228055
1935,Altai,32,1,0,0,32,3.4965075614664802,36,18,17,24,60,4.110873864173311
1935,Armenian,135,22,23,24,159,5.075173815233827,161,54,52,53,214,5.3706380281276624
1935,Balkar,8,2,0,0,8,2.1972245773362196,9,122,102,101,110,4.709530201312334
1935,Bashkir,61,3,0,0,61,4.127134385045092,70,96,53,108,178,5.187385805840755
1935,Belorussian,1174,177,85,140,1314,7.181591944611865,1335,676,340,523,1858,7.527793987721444
1935,Bulgarian,22,3,0,0,22,3.1354942159291497,24,27,16,6,30,3.4339872044851463
1935,Buryat,44,3,2,3,47,3.871201010907891,47,9,4,6,53,3.9889840465642745
1935,Estonian,101,46,33,40,141,4.955827057601261,106,407,440,475,581,6.366470447731438
1935,Finnish,50,19,6,6,56,4.04305126783455,69,100,56,60,129,4.867534450455582
1935,Georgian,82,6,0,0,82,4.418840607796598,96,34,13,9,105,4.663439094112067
1935,German,570,350,314,324,894,6.796823718274855,704,1343,1203,1203,1907,7.553810852008231
1935,Greek,8,73,57,51,59,4.0943445622221,12,383,361,338,350,5.860786223465865
1935,Hungarian,4,6,0,1,5,1.791759469228055,5,9,0,0,5,1.791759469228055
1935,Chechen,3,10,0,12,15,2.772588722239781,3,126,144,181,184,5.220355825078324
1935,Chinese,68,4,0,4,72,4.290459441148391,72,54,0,0,72,4.290459441148391
1935,Chuvash,234,46,206,172,406,6.008813185442595,240,123,277,138,378,5.937536205082426
1935,Japanese,2,5,0,0,2,1.0986122886681098,2,201,116,149,151,5.0238805208462765
1935,Jewish,554,127,124,130,684,6.529418838262226,641,208,168,175,816,6.705639094860003
1935,Kabardian,31,1,0,0,31,3.4657359027997265,34,23,7,15,49,3.912023005428146
1935,Kalmyk,2,0,0,0,2,1.0986122886681098,4,6,2,3,7,2.0794415416798357
1935,Karelian,26,55,35,0,26,3.295836866004329,28,127,0,0,28,3.367295829986474
1935,Kazakh,354,28,24,26,380,5.942799375126701,372,108,93,75,447,6.104793232414985
1935,Khakas,16,18,4,0,16,2.833213344056216,27,106,60,48,75,4.330733340286331
1935,Komi,130,26,49,37,167,5.123963979403259,135,48,0,0,135,4.912654885736052
1935,Korean,77,5,0,0,77,4.356708826689592,82,126,202,204,286,5.659482215759621
1935,Latvian,105,48,30,39,144,4.976733742420574,120,154,75,68,188,5.241747015059643
1935,Lithuanian,37,2,0,0,37,3.6375861597263857,38,15,0,11,49,3.912023005428146
1935,Mari,47,5,7,5,52,3.970291913552122,117,54,195,197,314,5.752572638825633
1935,Moldovan,8,6,0,0,8,2.1972245773362196,11,28,17,16,27,3.332204510175204
1935,Mordvin,108,33,53,15,123,4.820281565605037,122,148,336,234,356,5.877735781779639
1935,Ossetian,29,3,0,2,31,3.4657359027997265,70,10,0,2,72,4.290459441148391
1935,Polish,349,121,13,62,411,6.021023349349527,496,588,215,401,897,6.8001700683022
1935,Russian,10202,4112,4312,4329,14531,9.584108393341092,11571,14351,14747,15425,26996,10.203481027702058
1935,Tatar,418,24,0,23,441,6.091309882077698,493,357,291,319,812,6.70073110954781
1935,Udmurt,96,8,16,2,98,4.59511985013459,112,24,0,0,112,4.727387818712341
1935,Ukrainian,1079,214,206,154,1233,7.1180162044653335,1213,785,728,535,1748,7.466799475018602
1935,Uzbek,19,6,1,15,34,3.5553480614894135,19,30,26,58,77,4.356708826689592
1935,Yakut,7,12,0,0,7,2.0794415416798357,7,29,0,0,7,2.0794415416798357
1936,Altai,87,1,0,0,87,4.477336814478207,115,6,1,1,116,4.762173934797756
1936,Armenian,361,10,9,10,371,5.918893854273146,389,21,18,18,407,6.0112671744041615
1936,Balkar,2,1,0,0,2,1.0986122886681098,2,294,277,233,235,5.4638318050256105
1936,Bashkir,99,6,0,4,103,4.6443908991413725,109,113,144,88,197,5.288267030694535
1936,Belorussian,1185,136,43,95,1280,7.155396301896734,1270,272,0,110,1380,7.2305631534092925
1936,Bulgarian,22,4,0,0,22,3.1354942159291497,26,9,0,0,26,3.295836866004329
1936,Buryat,37,1,0,0,37,3.6375861597263857,38,18,18,14,52,3.970291913552122
1936,Estonian,135,28,13,19,154,5.043425116919247,166,65,23,44,210,5.351858133476067
1936,Finnish,49,17,6,7,56,4.04305126783455,74,39,9,16,90,4.51085950651685
1936,Georgian,320,14,13,14,334,5.814130531825066,340,27,19,23,363,5.8971538676367405
1936,German,682,196,155,159,841,6.7357800142423265,792,559,456,490,1282,7.1569563646156364
1936,Greek,25,33,9,0,25,3.258096538021482,33,116,64,64,97,4.584967478670572
1936,Hungarian,19,9,3,12,31,3.4657359027997265,21,15,0,8,29,3.4011973816621555
1936,Chechen,4,6,0,6,10,2.3978952727983707,5,426,651,668,673,6.513230110912307
1936,Chinese,77,6,0,2,79,4.382026634673881,90,92,62,21,111,4.718498871295094
1936,Chuvash,210,30,84,52,262,5.572154032177765,226,85,291,293,519,6.253828811575473
1936,Japanese,5,11,0,4,9,2.302585092994046,6,504,447,384,390,5.968707559985366
1936,Jewish,2054,118,116,122,2176,7.685703061234547,2225,238,226,237,2462,7.809135398120538
1936,Kabardian,13,0,0,0,13,2.6390573296152584,17,52,45,30,47,3.871201010907891
1936,Kalmyk,2,0,0,0,2,1.0986122886681098,5,16,15,10,15,2.772588722239781
1936,Karelian,14,47,30,0,14,2.70805020110221,26,105,0,0,26,3.295836866004329
1936,Kazakh,337,21,17,12,349,5.857933154483459,362,257,277,181,543,6.298949246855942
1936,Khakas,6,19,8,4,10,2.3978952727983707,9,49,20,18,27,3.332204510175204
1936,Komi,120,23,45,34,154,5.043425116919247,125,45,60,51,176,5.176149732573829
1936,Korean,74,8,6,7,81,4.406719247264253,105,87,143,141,246,5.5093883366279774
1936,Latvian,171,42,27,39,210,5.351858133476067,209,98,55,88,297,5.697093486505405
1936,Lithuanian,69,0,0,0,69,4.248495242049359,76,2,0,0,76,4.343805421853684
1936,Mari,70,2,0,0,70,4.2626798770413155,182,17,44,32,214,5.3706380281276624
1936,Moldovan,5,5,0,0,5,1.791759469228055,6,13,0,2,8,2.1972245773362196
1936,Mordvin,133,27,39,8,141,4.955827057601261,164,77,142,124,288,5.666426688112432
1936,Ossetian,27,4,2,3,30,3.4339872044851463,130,14,9,1,131,4.882801922586371
1936,Polish,484,85,0,37,521,6.257667587882639,712,264,27,179,891,6.79346613258001
1936,Russian,13208,3664,3877,4024,17232,9.754581429281577,15604,7164,7077,7147,22751,10.032408332602968
1936,Tatar,403,39,17,40,443,6.095824562432225,464,565,589,526,990,6.898714534329988
1936,Udmurt,85,3,0,0,85,4.454347296253507,90,10,0,0,90,4.51085950651685
1936,Ukrainian,1289,155,111,51,1340,7.201170883281678,1501,498,518,566,2067,7.63433723562832
1936,Uzbek,3,10,15,28,31,3.4657359027997265,3,78,189,150,153,5.0369526024136295
1936,Yakut,16,16,12,3,19,2.995732273553991,16,35,1,0,16,2.833213344056216
1937,Altai,901,23,0,14,915,6.82001636467413,903,47,13,33,936,6.842683282238422
1937,Armenian,524,90,75,83,607,6.410174881966167,648,181,160,168,816,6.705639094860003
1937,Balkar,370,31,0,0,370,5.916202062607435,374,176,95,64,438,6.0844994130751715
1937,Bashkir,2071,211,63,235,2306,7.7437032581737535,2096,414,217,402,2498,7.823645930834952
1937,Belorussian,18768,1690,763,1273,20041,9.905585350618274,19491,2889,1330,1867,21358,9.969228475498804
1937,Bulgarian,205,35,0,0,205,5.327876168789581,218,80,0,0,218,5.389071729816501
1937,Buryat,1637,45,38,45,1682,7.428333194190806,1650,79,67,71,1721,7.451241684987676
1937,Estonian,2706,493,381,438,3144,8.05356916913454,2988,760,540,619,3607,8.190908881182514
1937,Finnish,2687,247,131,133,2820,7.944846711001996,2900,413,214,211,3111,8.043020885298283
1937,Georgian,267,103,59,70,337,5.823045895483019,383,185,116,121,504,6.22455842927536
1937,German,6153,2166,1687,1732,7885,8.972844314437573,6798,4292,3524,3586,10384,9.248117736310213
1937,Greek,612,345,56,0,612,6.418364935936212,682,743,308,200,882,6.78332520060396
1937,Hungarian,196,50,0,0,196,5.2832037287379885,216,105,0,22,238,5.476463551931511
1937,Chechen,21,171,124,209,230,5.442417710521793,26,708,882,1021,1047,6.954638864880987
1937,Chinese,701,47,0,16,717,6.576469569048224,754,411,175,0,754,6.626717749249025
1937,Chuvash,2455,423,1759,1489,3944,8.280204233279974,2495,782,3608,2903,5398,8.593969030218288
1937,Japanese,23,528,308,243,266,5.58724865840025,24,1069,690,588,612,6.418364935936212
1937,Jewish,7267,932,871,930,8197,9.011645501064283,8236,1636,1531,1587,9823,9.192583650386924
1937,Kabardian,1061,22,0,10,1071,6.977281341630747,1108,80,7,39,1147,7.045776576879511
1937,Kalmyk,17,13,3,8,25,3.258096538021482,48,43,28,29,77,4.356708826689592
1937,Karelian,2352,617,817,449,2801,7.938088726896952,2460,1085,1598,770,3230,8.080546965824498
1937,Kazakh,9740,1002,1076,595,10335,9.243388226022383,10056,1419,1494,845,10901,9.296701537624227
1937,Khakas,487,176,43,12,499,6.214608098422191,551,296,69,15,566,6.340359303727752
1937,Komi,1137,222,355,249,1386,7.234898420314831,1170,356,519,318,1488,7.305860032684009
1937,Korean,754,68,28,34,788,6.670766320845874,960,553,884,902,1862,7.529943370601589
1937,Latvian,6753,804,771,904,7657,8.943506132037239,7155,1242,1128,1303,8458,9.042986242304014
1937,Lithuanian,722,48,0,41,763,6.638567789166521,763,83,0,70,833,6.726233402358747
1937,Mari,549,37,8,0,549,6.309918278226516,1374,84,115,33,1407,7.249925536717988
1937,Moldovan,211,44,0,0,211,5.356586274672012,221,155,182,166,387,5.961005339623274
1937,Mordvin,1377,338,616,315,1692,7.4342573821331355,1530,716,1842,1297,2827,7.947325027016463
1937,Ossetian,104,18,0,0,104,4.653960350157523,1091,77,39,43,1134,7.034387929915503
1937,Polish,14023,1437,453,953,14976,9.614270969992395,15059,2630,1001,1766,16825,9.73068058811076
1937,Russian,157725,38590,40176,40136,197861,12.19532509698341,172363,61530,62862,59608,231971,12.354371953709693
1937,Tatar,6275,823,636,602,6877,8.83608319099221,6703,1784,1529,1473,8176,9.009080614161977
1937,Udmurt,779,69,62,0,779,6.659293919683638,807,132,260,0,807,6.694562058521095
1937,Ukrainian,14694,2126,2114,1779,16473,9.709538659501193,16312,4715,6186,5795,22107,10.003694812953153
1937,Uzbek,268,478,1223,1356,1624,7.393263094763838,268,631,1548,1661,1929,7.5652752818989315
1937,Yakut,54,136,0,0,54,4.007333185232471,59,237,0,0,59,4.0943445622221
1938,Altai,118,18,13,7,125,4.836281906951478,118,29,23,19,137,4.927253685157205
1938,Armenian,368,65,62,67,435,6.077642243349034,491,116,114,117,608,6.411818267709897
1938,Balkar,107,22,0,0,107,4.68213122712422,107,45,11,0,107,4.68213122712422
1938,Bashkir,391,103,35,0,391,5.971261839790462,403,179,97,74,477,6.169610732491456
1938,Belorussian,7676,981,711,1019,8695,9.070618428801046,8114,1602,1298,1462,9576,9.16711966952162
1938,Bulgarian,224,21,0,0,224,5.41610040220442,245,61,54,48,293,5.683579767338681
1938,Buryat,2192,25,22,23,2215,7.703459047867175,2202,41,38,39,2241,7.715123603632105
1938,Estonian,3435,631,721,740,4175,8.337109129562474,3832,908,1022,1008,4840,8.484876589939695
1938,Finnish,3234,177,134,128,3362,8.12058871174027,3456,295,234,216,3672,8.208764045819667
1938,Georgian,56,30,0,1,57,4.060443010546419,149,73,40,36,185,5.225746673713202
1938,German,8658,1569,1395,1404,10062,9.216620609933333,9191,3020,2806,2770,11961,9.389490237604502
1938,Greek,586,171,35,40,626,6.440946540632921,647,409,257,243,890,6.792344427470809
1938,Hungarian,562,56,35,61,623,6.436150368369428,582,82,46,60,642,6.466144724237619
1938,Chechen,34,215,275,294,328,5.796057750765372,36,274,331,358,394,5.978885764901122
1938,Chinese,6882,636,592,612,7494,8.921991410536698,7086,764,685,701,7787,8.960339366492091
1938,Chuvash,584,178,602,654,1238,7.122059881629142,605,287,1076,977,1582,7.367077059881012
1938,Japanese,14,877,763,590,604,6.405228458030842,16,947,776,614,630,6.447305862541213
1938,Jewish,3733,402,369,390,4123,8.32457884513685,4444,881,854,866,5310,8.577535420422398
1938,Kabardian,224,16,0,2,226,5.424950017481403,226,28,0,11,237,5.472270673671475
1938,Kalmyk,16,14,10,10,26,3.295836866004329,23,18,11,12,35,3.58351893845611
1938,Karelian,1191,282,318,296,1487,7.305188215393037,1269,431,497,299,1568,7.358193752733032
1938,Kazakh,4160,1066,1192,699,4859,8.48879371689454,4317,1114,1222,711,5028,8.522976436171964
1938,Khakas,388,124,66,69,457,6.126869184114185,413,168,77,73,486,6.18826412308259
1938,Komi,195,85,88,81,276,5.6240175061873385,201,123,110,79,280,5.638354669333745
1938,Korean,2203,97,137,116,2319,7.749322464660356,2267,137,188,161,2428,7.795234929002173
1938,Latvian,4698,569,632,624,5322,8.579792333172758,5037,853,939,886,5923,8.68676717538769
1938,Lithuanian,693,38,23,36,729,6.593044534142437,740,53,27,40,780,6.660575149839686
1938,Mari,261,24,34,11,272,5.60947179518496,691,49,113,86,777,6.656726524178391
1938,Moldovan,180,34,19,34,214,5.3706380281276624,190,80,124,116,306,5.726847747587197
1938,Mordvin,473,135,145,126,599,6.396929655216146,561,235,389,306,867,6.7661917146603505
1938,Ossetian,46,9,0,0,46,3.8501476017100584,137,16,0,0,137,4.927253685157205
1938,Polish,10171,1031,645,814,10985,9.304377013902565,11156,1964,1466,1635,12791,9.45657525451379
1938,Russian,71450,14105,13719,13886,85336,11.354363402620459,79882,20547,19635,18885,98767,11.500528944633677
1938,Tatar,2603,785,767,704,3307,8.104099056143582,2841,1089,1038,977,3818,8.247743887225516
1938,Udmurt,165,38,83,79,244,5.501258210544727,174,62,170,134,308,5.733341276897746
1938,Ukrainian,9237,950,856,951,10188,9.229063985974285,10262,2059,2750,2854,13116,9.481664377815145
1938,Uzbek,129,459,1251,1287,1416,7.256297239690681,129,473,1246,1277,1406,7.249215057114389
1938,Yakut,280,60,0,0,280,5.638354669333745,283,103,0,0,283,5.648974238161206
1939,Altai,15,0,0,0,15,2.772588722239781,15,1,0,0,15,2.772588722239781
1939,Armenian,13,2,2,2,15,2.772588722239781,52,10,6,6,58,4.07753744390572
1939,Balkar,3,0,0,0,3,1.3862943611198906,4,17,8,12,16,2.833213344056216
1939,Bashkir,41,3,0,1,42,3.7612001156935624,56,70,74,122,178,5.187385805840755
1939,Belorussian,1737,24,7,10,1747,7.466227556215481,2871,130,0,0,2871,7.962763930168115
1939,Bulgarian,4,1,0,0,4,1.6094379124341003,7,19,22,24,31,3.4657359027997265
1939,Buryat,16,1,1,1,17,2.8903717578961645,20,6,4,6,26,3.295836866004329
1939,Estonian,14,3,0,1,15,2.772588722239781,89,123,114,100,189,5.247024072160486
1939,Finnish,14,3,1,1,15,2.772588722239781,136,294,323,330,466,6.1463292576688975
1939,Georgian,8,3,3,3,11,2.4849066497880004,10,12,0,0,10,2.3978952727983707
1939,German,88,21,12,13,101,4.624972813284271,592,1220,1210,1192,1784,7.487173694213739
1939,Greek,10,11,9,8,18,2.9444389791664403,29,120,87,109,138,4.9344739331306915
1939,Hungarian,6,2,2,3,9,2.302585092994046,12,7,0,0,12,2.5649493574615367
1939,Chechen,1,2,1,2,3,1.3862943611198906,1,31,22,24,25,3.258096538021482
1939,Chinese,112,3,1,0,112,4.727387818712341,201,27,1,15,216,5.37989735354046
1939,Chuvash,64,4,1,0,64,4.174387269895637,77,24,0,19,96,4.574710978503383
1939,Japanese,2,11,8,5,7,2.0794415416798357,2,34,0,13,15,2.772588722239781
1939,Jewish,351,4,2,2,353,5.869296913133774,1523,940,1003,1003,2526,7.834788107388194
1939,Kabardian,5,1,0,1,6,1.9459101490553132,6,8,0,6,12,2.5649493574615367
1939,Kalmyk,1,0,0,0,1,0.6931471805599453,4,4,2,3,7,2.0794415416798357
1939,Karelian,4,9,9,2,6,1.9459101490553132,7,25,0,0,7,2.0794415416798357
1939,Kazakh,212,16,17,3,215,5.375278407684165,217,40,31,23,240,5.484796933490655
1939,Khakas,15,4,2,2,17,2.8903717578961645,22,23,0,7,29,3.4011973816621555
1939,Komi,45,2,0,0,45,3.828641396489095,46,11,0,1,47,3.871201010907891
1939,Korean,29,4,6,6,35,3.58351893845611,32,14,8,14,46,3.8501476017100584
1939,Latvian,33,8,6,8,41,3.7376696182833684,70,74,37,0,70,4.2626798770413155
1939,Lithuanian,41,0,0,0,41,3.7376696182833684,65,9,0,0,65,4.189654742026425
1939,Mari,27,1,2,2,29,3.4011973816621555,91,13,31,50,141,4.955827057601261
1939,Moldovan,6,0,0,0,6,1.9459101490553132,9,9,0,0,9,2.302585092994046
1939,Mordvin,29,7,19,15,44,3.8066624897703196,33,23,0,23,56,4.04305126783455
1939,Ossetian,10,1,1,1,11,2.4849066497880004,68,3,0,0,68,4.23410650459726
1939,Polish,1810,34,21,31,1841,7.518607216815252,6883,4148,4879,5165,12048,9.396736947923277
1939,Russian,3333,600,623,639,3972,8.287276755814599,4579,2011,956,2050,6629,8.799360083179907
1939,Tatar,170,18,16,15,185,5.225746673713202,214,125,86,65,279,5.634789603169249
1939,Udmurt,24,2,11,9,33,3.5263605246161616,26,2,0,0,26,3.295836866004329
1939,Ukrainian,393,39,47,42,435,6.077642243349034,826,360,316,531,1357,7.213768308118642
1939,Uzbek,8,13,35,38,46,3.8501476017100584,8,17,20,42,50,3.9318256327243257
1939,Yakut,23,2,0,0,23,3.1780538303479458,25,10,0,0,25,3.258096538021482
1940,Altai,11,0,0,0,11,2.4849066497880004,12,5,0,0,12,2.5649493574615367
1940,Armenian,20,6,6,6,26,3.295836866004329,35,18,8,1,36,3.6109179126442243
1940,Balkar,5,3,1,2,7,2.0794415416798357,5,18,0,12,17,2.8903717578961645
1940,Bashkir,67,8,1,7,74,4.31748811353631,75,69,0,116,191,5.2574953720277815
1940,Belorussian,2845,58,10,24,2869,7.962067308753666,3826,202,0,0,3826,8.249836485425702
1940,Bulgarian,4,1,0,0,4,1.6094379124341003,6,17,0,0,6,1.9459101490553132
1940,Buryat,15,2,2,2,17,2.8903717578961645,15,7,2,6,21,3.091042453358316
1940,Estonian,18,7,0,1,19,2.995732273553991,361,551,631,506,867,6.7661917146603505
1940,Finnish,95,7,2,2,97,4.584967478670572,993,1465,1695,1703,2696,7.89989532313973
1940,Georgian,8,2,0,0,8,2.1972245773362196,10,16,0,0,10,2.3978952727983707
1940,German,159,56,33,36,195,5.278114659230517,3056,6001,6297,6235,9291,9.1369090938903
1940,Greek,5,12,0,0,5,1.791759469228055,14,263,191,236,250,5.5254529391317835
1940,Hungarian,7,4,1,5,12,2.5649493574615367,10,29,0,0,10,2.3978952727983707
1940,Chechen,0,7,5,8,8,2.1972245773362196,0,48,16,9,9,2.302585092994046
1940,Chinese,131,0,0,0,131,4.882801922586371,140,6,0,0,140,4.948759890378168
1940,Chuvash,117,14,40,24,141,4.955827057601261,123,42,0,0,123,4.820281565605037
1940,Japanese,3,20,11,10,13,2.6390573296152584,3,53,0,0,3,1.3862943611198906
1940,Jewish,1930,62,62,66,1996,7.599401333415815,7959,4862,5274,5317,13276,9.493788493895902
1940,Kabardian,12,0,0,0,12,2.5649493574615367,12,7,0,1,13,2.6390573296152584
1940,Kalmyk,4,3,3,3,7,2.0794415416798357,12,10,6,9,21,3.091042453358316
1940,Karelian,30,26,39,23,53,3.9889840465642745,39,83,0,0,39,3.6888794541139363
1940,Kazakh,394,36,38,20,414,6.028278520230698,396,75,54,60,456,6.124683390894205
1940,Khakas,6,6,0,0,6,1.9459101490553132,12,49,0,13,25,3.258096538021482
1940,Komi,115,8,11,6,121,4.804021044733257,119,28,0,20,139,4.941642422609304
1940,Korean,18,1,0,0,18,2.9444389791664403,19,27,10,19,38,3.6635616461296463
1940,Latvian,53,18,10,17,70,4.2626798770413155,234,311,291,89,323,5.780743515792329
1940,Lithuanian,60,0,0,0,60,4.110873864173311,128,27,11,0,128,4.859812404361672
1940,Mari,32,3,8,7,39,3.6888794541139363,66,12,0,31,97,4.584967478670572
1940,Moldovan,33,3,2,3,36,3.6109179126442243,53,34,34,56,109,4.700480365792417
1940,Mordvin,93,22,72,63,156,5.056245805348308,115,63,0,135,250,5.5254529391317835
1940,Ossetian,8,1,0,0,8,2.1972245773362196,57,9,0,2,59,4.0943445622221
1940,Polish,4535,99,69,98,4633,8.441175704992322,9411,3158,3366,3697,13108,9.48105429619781
1940,Russian,6802,1581,1650,1664,8466,9.043931533642278,7874,3838,1370,3753,11627,9.361171261678766
1940,Tatar,401,38,31,32,433,6.073044534100405,437,147,38,91,528,6.270988431858299
1940,Udmurt,82,1,0,0,82,4.418840607796598,85,5,0,0,85,4.454347296253507
1940,Ukrainian,733,75,59,42,775,6.654152520183219,1337,405,0,375,1712,7.44600149832412
1940,Uzbek,8,18,46,51,59,4.0943445622221,8,21,0,51,59,4.0943445622221
1940,Yakut,4,7,4,0,4,1.6094379124341003,5,21,0,0,5,1.791759469228055
1941,Altai,50,2,0,0,50,3.9318256327243257,51,13,0,0,51,3.9512437185814275
1941,Armenian,81,9,6,6,87,4.477336814478207,99,88,63,58,157,5.062595033026967
1941,Balkar,4,5,0,0,4,1.6094379124341003,4,46,0,12,16,2.833213344056216
1941,Bashkir,154,33,9,34,188,5.241747015059643,166,88,0,106,272,5.60947179518496
1941,Belorussian,1133,211,8,98,1231,7.116394144093465,1256,785,0,196,1452,7.2813856635702825
1941,Bulgarian,15,7,0,0,15,2.772588722239781,20,95,67,53,73,4.30406509320417
1941,Buryat,37,7,6,7,44,3.8066624897703196,38,21,4,20,58,4.07753744390572
1941,Estonian,154,62,38,51,205,5.327876168789581,182,737,633,45,227,5.429345628954441
1941,Finnish,51,38,19,21,72,4.290459441148391,111,311,163,72,183,5.214935757608986
1941,Georgian,22,16,9,9,31,3.4657359027997265,32,94,13,4,36,3.6109179126442243
1941,German,1850,456,392,411,2261,7.724004656676065,21702,46127,49668,50485,72187,11.187029106081189
1941,Greek,31,109,83,77,108,4.6913478822291435,55,1349,1310,1408,1463,7.288927694521257
1941,Hungarian,26,10,0,4,30,3.4339872044851463,27,87,0,0,27,3.332204510175204
1941,Chechen,4,18,5,15,19,2.995732273553991,5,119,0,107,112,4.727387818712341
1941,Chinese,154,17,0,7,161,5.087596335232384,173,36,0,0,173,5.159055299214529
1941,Chuvash,481,65,259,226,707,6.56244409369372,487,160,0,361,848,6.744059186311348
1941,Japanese,1,92,57,42,43,3.784189633918261,3,232,0,0,3,1.3862943611198906
1941,Jewish,795,150,141,149,944,6.851184927493743,1075,743,618,408,1483,7.302496423727326
1941,Kabardian,24,7,0,6,30,3.4339872044851463,24,36,0,25,49,3.912023005428146
1941,Kalmyk,2,3,1,2,4,1.6094379124341003,31,19,6,15,46,3.8501476017100584
1941,Karelian,18,92,96,49,67,4.219507705176107,19,380,0,0,19,2.995732273553991
1941,Kazakh,731,234,257,190,921,6.826545223556594,739,633,626,634,1373,7.2254814727822945
1941,Khakas,24,36,16,12,36,3.6109179126442243,32,139,0,36,68,4.23410650459726
1941,Komi,336,25,17,1,337,5.823045895483019,341,108,0,104,445,6.100318952020064
1941,Korean,59,17,16,17,76,4.343805421853684,69,121,102,80,149,5.0106352940962555
1941,Latvian,368,69,39,55,423,6.049733455231958,461,828,701,0,461,6.135564891081739
1941,Lithuanian,1365,27,32,40,1405,7.2485040723706105,1542,138,122,172,1714,7.44716835960004
1941,Mari,117,12,31,26,143,4.969813299576001,194,36,0,88,282,5.645446897643238
1941,Moldovan,155,10,2,5,160,5.081404364984463,213,187,373,457,670,6.508769136971682
1941,Mordvin,230,60,134,96,326,5.7899601708972535,279,180,0,315,594,6.38856140554563
1941,Ossetian,22,9,6,7,29,3.4011973816621555,64,16,0,6,70,4.2626798770413155
1941,Polish,1178,252,102,198,1376,7.227662498728654,2153,1885,649,1034,3187,8.067149039910106
1941,Russian,20722,5994,6214,6310,27032,10.204813620903147,23200,12029,4232,9953,33153,10.408918651984811
1941,Tatar,973,130,100,95,1068,6.974478911025045,1038,293,0,191,1229,7.114769448366463
1941,Udmurt,212,10,0,0,212,5.3612921657094255,224,36,0,11,235,5.4638318050256105
1941,Ukrainian,2422,277,193,147,2569,7.851661177889265,2850,968,0,647,3497,8.159946655578548
1941,Uzbek,23,73,186,202,225,5.420534999272286,23,88,55,200,223,5.4116460518550396
1941,Yakut,46,18,0,0,46,3.8501476017100584,51,100,0,0,51,3.9512437185814275
1942,Altai,15,5,3,5,20,3.044522437723423,15,15,4,0,15,2.772588722239781
1942,Armenian,91,7,4,5,96,4.574710978503383,113,194,213,201,314,5.752572638825633
1942,Balkar,3,6,0,2,5,1.791759469228055,4,81,54,45,49,3.912023005428146
1942,Bashkir,205,19,0,15,220,5.3981627015177525,214,110,24,139,353,5.869296913133774
1942,Belorussian,593,197,31,96,689,6.536691597591305,642,552,0,185,827,6.71901315438526
1942,Bulgarian,17,9,4,4,21,3.091042453358316,23,68,92,0,23,3.1780538303479458
1942,Buryat,74,3,1,2,76,4.343805421853684,74,15,9,11,85,4.454347296253507
1942,Estonian,154,45,21,35,189,5.247024072160486,204,272,211,155,359,5.886104031450156
1942,Finnish,67,48,35,38,105,4.663439094112067,303,240,197,190,493,6.202535517187923
1942,Georgian,38,12,4,5,43,3.784189633918261,47,56,31,0,47,3.871201010907891
1942,German,2487,275,206,219,2706,7.903596289614301,4014,6645,6902,6988,11002,9.305923241869912
1942,Greek,21,81,53,43,64,4.174387269895637,128,4049,5282,5382,5510,8.614501373883236
1942,Hungarian,28,5,0,0,28,3.367295829986474,29,45,0,0,29,3.4011973816621555
1942,Chechen,8,18,8,21,29,3.4011973816621555,9,233,292,311,320,5.771441123130016
1942,Chinese,103,3,0,0,103,4.6443908991413725,115,35,0,0,115,4.7535901911063645
1942,Chuvash,345,57,227,174,519,6.253828811575473,360,178,428,484,844,6.739336627357174
1942,Japanese,1,69,39,34,35,3.58351893845611,1,429,305,261,262,5.572154032177765
1942,Jewish,621,113,103,111,732,6.597145701886651,675,395,348,324,999,6.907755278982137
1942,Kabardian,6,2,0,0,6,1.9459101490553132,8,46,24,36,44,3.8066624897703196
1942,Kalmyk,8,1,0,0,8,2.1972245773362196,118,23,19,18,136,4.919980925828125
1942,Karelian,21,81,86,20,41,3.7376696182833684,26,289,165,62,88,4.48863636973214
1942,Kazakh,1286,162,176,132,1418,7.257707677160043,1338,852,935,913,2251,7.719573989259581
1942,Khakas,5,37,20,15,20,3.044522437723423,9,139,72,63,72,4.290459441148391
1942,Komi,229,24,23,4,233,5.455321115357702,244,81,37,5,249,5.521460917862246
1942,Korean,27,10,5,6,33,3.5263605246161616,29,91,118,109,138,4.9344739331306915
1942,Latvian,141,44,11,29,170,5.14166355650266,171,293,212,147,318,5.765191102784844
1942,Lithuanian,81,2,0,0,81,4.406719247264253,116,19,0,14,130,4.875197323201151
1942,Mari,125,3,0,0,125,4.836281906951478,230,17,0,0,230,5.442417710521793
1942,Moldovan,54,5,0,0,54,4.007333185232471,59,53,69,0,59,4.0943445622221
1942,Mordvin,256,52,114,67,323,5.780743515792329,347,157,178,224,571,6.349138991379798
1942,Ossetian,95,4,1,2,97,4.584967478670572,181,21,8,10,191,5.2574953720277815
1942,Polish,420,148,0,85,505,6.226536669287466,523,620,41,346,869,6.76849321164863
1942,Russian,22148,5553,5825,5930,28078,10.242777244969993,26405,12208,10662,11495,37900,10.542732775946709
1942,Tatar,1106,98,69,82,1188,7.080867896690782,1208,341,218,228,1436,7.270312886079025
1942,Udmurt,214,6,0,0,214,5.3706380281276624,250,37,26,40,290,5.673323267171493
1942,Ukrainian,2290,325,364,308,2598,7.8628820346414905,2497,883,489,718,3215,8.075893630298857
1942,Uzbek,54,50,123,137,191,5.2574953720277815,56,71,119,116,172,5.153291594497779
1942,Yakut,63,15,0,0,63,4.1588830833596715,71,68,0,0,71,4.276666119016055
1943,Altai,5,0,0,0,5,1.791759469228055,5,30,43,34,39,3.6888794541139363
1943,Armenian,140,5,4,4,144,4.976733742420574,169,58,58,59,228,5.43372200355424
1943,Balkar,1,5,2,4,5,1.791759469228055,1,835,799,597,598,6.395261598115449
1943,Bashkir,74,11,0,17,91,4.5217885770490405,77,166,205,0,77,4.356708826689592
1943,Belorussian,413,104,17,39,452,6.115892125483034,447,214,0,74,521,6.257667587882639
1943,Bulgarian,13,1,0,0,13,2.6390573296152584,42,28,23,30,72,4.290459441148391
1943,Buryat,27,2,1,2,29,3.4011973816621555,27,52,58,34,61,4.127134385045092
1943,Estonian,85,18,3,11,96,4.574710978503383,101,54,0,2,103,4.6443908991413725
1943,Finnish,16,9,0,0,16,2.833213344056216,21,49,1,25,46,3.8501476017100584
1943,Georgian,26,2,0,0,26,3.295836866004329,30,15,0,0,30,3.4339872044851463
1943,German,991,134,97,103,1094,6.9985096422506015,1289,2590,2595,2759,4048,8.30622521603216
1943,Greek,15,59,50,47,62,4.143134726391533,52,198,125,176,228,5.43372200355424
1943,Hungarian,11,7,1,10,21,3.091042453358316,14,18,0,0,14,2.70805020110221
1943,Chechen,4,5,0,5,9,2.302585092994046,11,1732,2733,2757,2768,7.926241523170962
1943,Chinese,73,0,0,0,73,4.30406509320417,78,10,0,0,78,4.3694478524670215
1943,Chuvash,128,32,140,112,240,5.484796933490655,138,72,0,246,384,5.953243334287785
1943,Japanese,2,26,10,13,15,2.772588722239781,2,3371,3233,2897,2899,7.9724660159745655
1943,Jewish,379,56,50,54,433,6.073044534100405,424,155,116,131,555,6.320768294250582
1943,Kabardian,9,1,0,0,9,2.302585092994046,9,204,203,123,132,4.890349128221754
1943,Kalmyk,9,1,0,1,10,2.3978952727983707,754,180,197,171,925,6.8308742346461795
1943,Karelian,7,34,0,0,7,2.0794415416798357,7,94,0,0,7,2.0794415416798357
1943,Kazakh,854,66,70,55,909,6.813444599510896,907,989,1108,747,1654,7.411556287811163
1943,Khakas,1,15,6,3,4,1.6094379124341003,1,51,3,22,23,3.1780538303479458
1943,Komi,54,10,2,0,54,4.007333185232471,55,29,0,0,55,4.02535169073515
1943,Korean,14,10,12,13,27,3.332204510175204,14,70,98,65,79,4.382026634673881
1943,Latvian,97,16,0,5,102,4.634728988229636,109,60,0,0,109,4.700480365792417
1943,Lithuanian,25,1,0,0,25,3.258096538021482,34,10,0,9,43,3.784189633918261
1943,Mari,39,0,0,0,39,3.6888794541139363,81,39,129,111,192,5.262690188904886
1943,Moldovan,52,2,0,0,52,3.970291913552122,57,15,0,9,66,4.204692619390966
1943,Mordvin,81,27,58,30,111,4.718498871295094,124,56,0,58,182,5.209486152841421
1943,Ossetian,158,3,1,2,160,5.081404364984463,224,29,23,0,224,5.41610040220442
1943,Polish,482,106,34,80,562,6.333279628139691,693,280,0,185,878,6.778784897685177
1943,Russian,12843,2979,3138,3213,16056,9.683900170549684,14799,5542,3968,5307,20106,9.908823292125648
1943,Tatar,516,28,9,13,529,6.272877006546167,600,1156,1243,1016,1616,7.388327859577107
1943,Udmurt,90,4,0,0,90,4.51085950651685,105,25,31,66,171,5.147494476813453
1943,Ukrainian,1495,181,216,180,1675,7.424165281042028,1637,355,0,342,1979,7.590852123688581
1943,Uzbek,51,20,46,55,106,4.672828834461906,51,269,718,494,545,6.302618975744905
1943,Yakut,25,10,0,0,25,3.258096538021482,30,27,0,0,30,3.4339872044851463
1944,Altai,7,1,0,1,8,2.1972245773362196,7,19,23,10,17,2.8903717578961645
1944,Armenian,23,3,2,3,26,3.295836866004329,166,251,288,290,456,6.124683390894205
1944,Balkar,13,6,4,5,18,2.9444389791664403,14,902,866,649,663,6.498282149476434
1944,Bashkir,29,5,0,4,33,3.5263605246161616,33,149,185,0,33,3.5263605246161616
1944,Belorussian,2818,67,43,43,2861,7.959275960116396,2878,223,0,133,3011,8.010359588919783
1944,Bulgarian,8,0,0,0,8,2.1972245773362196,140,124,254,248,388,5.963579343618446
1944,Buryat,12,0,0,0,12,2.5649493574615367,12,60,68,40,52,3.970291913552122
1944,Estonian,75,26,25,28,103,4.6443908991413725,96,64,0,39,135,4.912654885736052
1944,Finnish,7,16,14,13,20,3.044522437723423,13,64,26,50,63,4.1588830833596715
1944,Georgian,6,4,3,3,9,2.302585092994046,8,33,20,18,26,3.295836866004329
1944,German,546,74,57,57,603,6.403574197934815,911,1355,1270,1406,2317,7.748460023899697
1944,Greek,8,28,24,22,30,3.4339872044851463,277,454,490,525,802,6.688354713946762
1944,Hungarian,6,2,0,0,6,1.9459101490553132,6,19,0,0,6,1.9459101490553132
1944,Chechen,103,9,9,13,116,4.762173934797756,151,1824,2888,2880,3031,8.016977746762262
1944,Chinese,33,1,0,0,33,3.5263605246161616,39,7,0,0,39,3.6888794541139363
1944,Chuvash,72,8,0,0,72,4.290459441148391,77,47,0,0,77,4.356708826689592
1944,Japanese,4,19,11,13,17,2.8903717578961645,5,3221,3094,2768,2773,7.928045600874777
1944,Jewish,237,36,34,36,273,5.6131281063880705,277,104,66,84,361,5.8916442118257715
1944,Kabardian,0,0,0,0,0,0,0,231,234,145,145,4.983606621708336
1944,Kalmyk,10,2,2,2,12,2.5649493574615367,75,339,375,350,425,6.054439346269371
1944,Karelian,7,32,90,72,79,4.382026634673881,7,90,0,29,36,3.6109179126442243
1944,Kazakh,230,25,26,21,251,5.529429087511423,243,830,929,600,843,6.7381524945959574
1944,Khakas,0,7,3,1,1,0.6931471805599453,1,86,49,67,68,4.23410650459726
1944,Komi,22,8,13,9,31,3.4657359027997265,22,24,0,0,22,3.1354942159291497
1944,Korean,12,5,6,6,18,2.9444389791664403,12,102,164,133,145,4.983606621708336
1944,Latvian,64,22,18,20,84,4.442651256490317,70,63,0,20,90,4.51085950651685
1944,Lithuanian,43,2,0,2,45,3.828641396489095,51,7,0,5,56,4.04305126783455
1944,Mari,22,2,4,5,27,3.332204510175204,41,43,155,137,178,5.187385805840755
1944,Moldovan,52,2,0,0,52,3.970291913552122,59,26,26,26,85,4.454347296253507
1944,Mordvin,65,15,40,30,95,4.564348191467836,87,48,0,61,148,5.003946305945459
1944,Ossetian,11,1,0,0,11,2.4849066497880004,45,24,18,0,45,3.828641396489095
1944,Polish,1657,74,46,60,1717,7.4489161025442,2255,253,0,173,2428,7.795234929002173
1944,Russian,5597,1243,1273,1270,6867,8.834628222017367,6653,3203,1376,2710,9363,9.144627828610801
1944,Tatar,246,24,17,22,268,5.594711379601839,360,1898,2129,2049,2409,7.787382026484701
1944,Udmurt,36,1,0,0,36,3.6109179126442243,40,25,58,75,115,4.7535901911063645
1944,Ukrainian,919,118,178,172,1091,6.9957661563048505,1068,428,110,646,1714,7.44716835960004
1944,Uzbek,20,7,15,18,38,3.6635616461296463,20,223,593,343,363,5.8971538676367405
1944,Yakut,13,2,0,0,13,2.6390573296152584,14,21,0,0,14,2.70805020110221
1945,Altai,1,0,0,0,1,0.6931471805599453,1,4,0,3,4,1.6094379124341003
1945,Armenian,40,2,1,1,41,3.7376696182833684,62,22,20,19,81,4.406719247264253
1945,Balkar,13,2,1,1,14,2.70805020110221,14,13,4,7,21,3.091042453358316
1945,Bashkir,26,0,0,0,26,3.295836866004329,26,46,22,78,104,4.653960350157523
1945,Belorussian,1593,73,62,66,1659,7.414572881350589,1841,255,4,181,2022,7.612336837167746
1945,Bulgarian,39,2,1,0,39,3.6888794541139363,66,21,25,22,88,4.48863636973214
1945,Buryat,29,1,1,1,30,3.4339872044851463,29,7,5,7,36,3.6109179126442243
1945,Estonian,35,15,11,11,46,3.8501476017100584,63,124,112,39,102,4.634728988229636
1945,Finnish,7,48,53,54,61,4.127134385045092,7,120,112,102,109,4.700480365792417
1945,Georgian,16,2,0,0,16,2.833213344056216,20,18,8,5,25,3.258096538021482
1945,German,581,83,69,70,651,6.480044561926653,1744,5554,5952,6042,7786,8.960210955576986
1945,Greek,21,29,26,25,46,3.8501476017100584,53,181,166,173,226,5.424950017481403
1945,Hungarian,10,2,0,0,10,2.3978952727983707,10,24,17,0,10,2.3978952727983707
1945,Chechen,110,6,5,8,118,4.77912349311153,110,29,17,32,142,4.962844630259907
1945,Chinese,227,2,0,1,228,5.43372200355424,236,4,0,0,236,5.4680601411351315
1945,Chuvash,78,19,111,95,173,5.159055299214529,81,38,0,71,152,5.030437921392435
1945,Japanese,205,11,4,4,209,5.3471075307174685,206,17,0,0,206,5.332718793265369
1945,Jewish,159,33,31,33,192,5.262690188904886,173,135,118,92,265,5.583496308781699
1945,Kabardian,2,1,0,1,3,1.3862943611198906,3,4,0,2,5,1.791759469228055
1945,Kalmyk,58,0,0,0,58,4.07753744390572,69,34,36,37,106,4.672828834461906
1945,Karelian,2,21,34,8,10,2.3978952727983707,2,67,0,0,2,1.0986122886681098
1945,Kazakh,302,23,24,12,314,5.752572638825633,317,25,13,9,326,5.7899601708972535
1945,Khakas,9,5,1,0,9,2.302585092994046,9,33,7,14,23,3.1780538303479458
1945,Komi,25,2,0,0,25,3.258096538021482,25,9,0,0,25,3.258096538021482
1945,Korean,24,2,1,1,25,3.258096538021482,25,20,18,17,42,3.7612001156935624
1945,Latvian,44,22,19,21,65,4.189654742026425,53,136,121,23,76,4.343805421853684
1945,Lithuanian,53,2,1,2,55,4.02535169073515,58,25,25,32,90,4.51085950651685
1945,Mari,25,2,4,3,28,3.367295829986474,40,6,0,10,50,3.9318256327243257
1945,Moldovan,50,3,4,2,52,3.970291913552122,52,23,38,41,93,4.543294782270004
1945,Mordvin,55,10,15,1,56,4.04305126783455,64,44,0,87,151,5.0238805208462765
1945,Ossetian,10,1,0,1,11,2.4849066497880004,19,5,0,3,22,3.1354942159291497
1945,Polish,1389,50,20,27,1416,7.256297239690681,2393,370,200,225,2618,7.870547844507712
1945,Russian,5557,1115,1135,1077,6634,8.800113946766308,6486,2635,1650,2185,8671,9.067854723679428
1945,Tatar,236,18,11,18,254,5.541263545158426,267,86,36,42,309,5.736572297479192
1945,Udmurt,57,2,0,0,57,4.060443010546419,58,13,8,53,111,4.718498871295094
1945,Ukrainian,964,119,189,184,1148,7.046647277848756,1121,416,417,659,1780,7.484930283289661
1945,Uzbek,12,12,30,34,46,3.8501476017100584,12,14,10,35,47,3.871201010907891
1945,Yakut,28,4,0,0,28,3.367295829986474,28,18,0,0,28,3.367295829986474
1946,Altai,4,1,1,2,6,1.9459101490553132,4,2,0,2,6,1.9459101490553132
1946,Armenian,20,2,2,2,22,3.1354942159291497,29,12,12,11,40,3.713572066704308
1946,Balkar,5,5,4,5,10,2.3978952727983707,5,15,11,12,17,2.8903717578961645
1946,Bashkir,8,1,0,0,8,2.1972245773362196,10,38,47,62,72,4.290459441148391
1946,Belorussian,516,25,11,12,528,6.270988431858299,639,119,33,73,712,6.569481420414296
1946,Bulgarian,14,0,0,0,14,2.70805020110221,21,9,11,7,28,3.367295829986474
1946,Buryat,15,1,1,1,16,2.833213344056216,15,4,4,4,19,2.995732273553991
1946,Estonian,19,4,1,2,21,3.091042453358316,31,44,37,16,47,3.871201010907891
1946,Finnish,3,9,8,9,12,2.5649493574615367,5,47,43,41,46,3.8501476017100584
1946,Georgian,10,1,0,0,10,2.3978952727983707,13,16,18,16,29,3.4011973816621555
1946,German,467,58,53,56,523,6.261491684321042,1752,1595,1694,1717,3469,8.151909872940905
1946,Greek,6,15,14,14,20,3.044522437723423,33,105,110,110,143,4.969813299576001
1946,Hungarian,0,1,0,0,0,0,1,8,3,0,1,0.6931471805599453
1946,Chechen,63,1,0,1,64,4.174387269895637,63,19,19,23,86,4.465908118654584
1946,Chinese,24,0,0,0,24,3.2188758248682006,25,1,0,0,25,3.258096538021482
1946,Chuvash,49,5,13,5,54,4.007333185232471,50,20,7,37,87,4.477336814478207
1946,Japanese,77,7,4,5,82,4.418840607796598,78,10,0,0,78,4.3694478524670215
1946,Jewish,61,12,11,11,72,4.290459441148391,74,54,47,40,114,4.74493212836325
1946,Kabardian,0,0,0,0,0,0,1,3,0,2,3,1.3862943611198906
1946,Kalmyk,53,0,0,0,53,3.9889840465642745,60,9,9,10,70,4.2626798770413155
1946,Karelian,0,9,11,2,2,1.0986122886681098,0,27,0,0,0,0
1946,Kazakh,229,12,13,13,242,5.493061443340548,232,19,16,15,247,5.5134287461649825
1946,Khakas,3,6,4,4,7,2.0794415416798357,3,26,17,19,22,3.1354942159291497
1946,Komi,9,3,4,2,11,2.4849066497880004,10,13,11,17,27,3.332204510175204
1946,Korean,76,3,4,4,80,4.394449154672439,76,14,19,19,95,4.564348191467836
1946,Latvian,32,4,0,1,33,3.5263605246161616,34,65,63,38,72,4.290459441148391
1946,Lithuanian,47,3,4,5,52,3.970291913552122,61,17,22,24,85,4.454347296253507
1946,Mari,19,0,0,0,19,2.995732273553991,32,5,11,14,46,3.8501476017100584
1946,Moldovan,20,2,4,3,23,3.1780538303479458,21,13,28,25,46,3.8501476017100584
1946,Mordvin,27,4,3,0,27,3.332204510175204,30,18,0,16,46,3.8501476017100584
1946,Ossetian,2,0,0,0,2,1.0986122886681098,13,2,0,1,14,2.70805020110221
1946,Polish,490,21,6,12,502,6.220590170099739,1121,169,105,116,1237,7.121252453244542
1946,Russian,2970,542,556,560,3530,8.169336395928386,3517,1441,1141,1291,4808,8.478244441277663
1946,Tatar,133,8,4,9,142,4.962844630259907,152,83,71,56,208,5.342334251964811
1946,Udmurt,35,2,11,9,44,3.8066624897703196,36,4,0,0,36,3.6109179126442243
1946,Ukrainian,564,52,79,76,640,6.46302945692067,678,220,291,354,1032,6.940222469119639
1946,Uzbek,8,1,1,2,10,2.3978952727983707,8,4,0,7,15,2.772588722239781
1946,Yakut,4,2,0,0,4,1.6094379124341003,4,11,0,0,4,1.6094379124341003
1947,Altai,4,0,0,0,4,1.6094379124341003,4,0,0,0,4,1.6094379124341003
1947,Armenian,19,2,2,2,21,3.091042453358316,27,12,13,12,39,3.6888794541139363
1947,Balkar,2,3,2,3,5,1.791759469228055,2,8,6,4,6,1.9459101490553132
1947,Bashkir,10,0,0,0,10,2.3978952727983707,13,14,11,19,32,3.4965075614664802
1947,Belorussian,297,18,4,6,303,5.717027701406222,357,66,9,26,383,5.950642552587727
1947,Bulgarian,4,0,0,0,4,1.6094379124341003,19,11,20,15,34,3.5553480614894135
1947,Buryat,27,1,1,1,28,3.367295829986474,27,4,4,4,31,3.4657359027997265
1947,Estonian,11,3,1,1,12,2.5649493574615367,17,25,20,14,31,3.4657359027997265
1947,Finnish,2,3,2,2,4,1.6094379124341003,5,9,3,1,6,1.9459101490553132
1947,Georgian,3,4,5,5,8,2.1972245773362196,5,7,6,3,8,2.1972245773362196
1947,German,512,45,41,43,555,6.320768294250582,950,687,720,731,1681,7.427738840532894
1947,Greek,6,21,24,23,29,3.4011973816621555,14,133,162,161,175,5.170483995038151
1947,Hungarian,3,1,0,1,4,1.6094379124341003,3,5,2,0,3,1.3862943611198906
1947,Chechen,40,1,0,1,41,3.7376696182833684,40,22,28,30,70,4.2626798770413155
1947,Chinese,7,0,0,0,7,2.0794415416798357,7,0,0,0,7,2.0794415416798357
1947,Chuvash,43,6,29,25,68,4.23410650459726,44,16,44,43,87,4.477336814478207
1947,Japanese,47,2,0,1,48,3.8918202981106265,47,3,0,0,47,3.871201010907891
1947,Jewish,49,13,12,13,62,4.143134726391533,58,34,30,27,85,4.454347296253507
1947,Kabardian,2,2,2,2,4,1.6094379124341003,2,8,6,7,9,2.302585092994046
1947,Kalmyk,30,0,0,0,30,3.4339872044851463,31,5,5,5,36,3.6109179126442243
1947,Karelian,1,7,7,1,2,1.0986122886681098,5,28,33,21,26,3.295836866004329
1947,Kazakh,201,3,2,4,205,5.327876168789581,206,5,2,3,209,5.3471075307174685
1947,Khakas,0,5,4,3,3,1.3862943611198906,0,17,12,12,12,2.5649493574615367
1947,Komi,9,2,2,0,9,2.302585092994046,9,5,0,0,9,2.302585092994046
1947,Korean,7,1,1,1,8,2.1972245773362196,7,11,16,16,23,3.1780538303479458
1947,Latvian,17,2,0,0,17,2.8903717578961645,17,20,11,0,17,2.8903717578961645
1947,Lithuanian,27,3,4,5,32,3.4965075614664802,61,44,69,72,133,4.897839799950911
1947,Mari,8,1,3,3,11,2.4849066497880004,16,3,6,8,24,3.2188758248682006
1947,Moldovan,17,0,0,0,17,2.8903717578961645,22,7,14,10,32,3.4965075614664802
1947,Mordvin,18,3,1,0,18,2.9444389791664403,20,14,18,19,39,3.6888794541139363
1947,Ossetian,1,0,0,0,1,0.6931471805599453,5,0,0,0,5,1.791759469228055
1947,Polish,172,20,8,14,186,5.231108616854587,509,86,44,42,551,6.313548046277095
1947,Russian,2239,462,478,477,2716,7.907283609426348,2603,1063,934,954,3557,8.17695386822578
1947,Tatar,84,4,1,5,89,4.499809670330265,112,47,40,41,153,5.0369526024136295
1947,Udmurt,33,1,2,0,33,3.5263605246161616,34,1,0,0,34,3.5553480614894135
1947,Ukrainian,398,35,47,45,443,6.095824562432225,485,139,191,215,700,6.55250788703459
1947,Uzbek,7,0,0,0,7,2.0794415416798357,7,1,0,0,7,2.0794415416798357
1947,Yakut,2,1,0,0,2,1.0986122886681098,2,8,4,0,2,1.0986122886681098
1948,Altai,9,0,0,0,9,2.302585092994046,9,0,0,0,9,2.302585092994046
1948,Armenian,13,4,4,4,17,2.8903717578961645,19,62,72,71,90,4.51085950651685
1948,Balkar,2,0,0,0,2,1.0986122886681098,2,13,10,7,9,2.302585092994046
1948,Bashkir,8,0,0,0,8,2.1972245773362196,8,18,13,28,36,3.6109179126442243
1948,Belorussian,394,21,3,2,396,5.983936280687191,406,85,0,31,437,6.082218910376446
1948,Bulgarian,5,1,1,0,5,1.791759469228055,12,17,32,16,28,3.367295829986474
1948,Buryat,10,1,1,1,11,2.4849066497880004,10,3,3,3,13,2.6390573296152584
1948,Estonian,8,2,0,0,8,2.1972245773362196,16,31,23,10,26,3.295836866004329
1948,Finnish,5,5,4,4,9,2.302585092994046,7,30,25,23,30,3.4339872044851463
1948,Georgian,3,1,0,0,3,1.3862943611198906,8,14,16,6,14,2.70805020110221
1948,German,277,61,57,59,336,5.820082930352362,803,980,1029,1039,1842,7.519149957669823
1948,Greek,9,13,12,10,19,2.995732273553991,26,342,438,441,467,6.148468295917647
1948,Hungarian,1,1,0,0,1,0.6931471805599453,1,6,1,0,1,0.6931471805599453
1948,Chechen,21,0,0,0,21,3.091042453358316,22,38,51,52,74,4.31748811353631
1948,Chinese,33,1,0,1,34,3.5553480614894135,33,2,0,0,33,3.5263605246161616
1948,Chuvash,26,6,23,16,42,3.7612001156935624,26,29,129,134,160,5.081404364984463
1948,Japanese,116,2,0,1,117,4.770684624465665,117,13,0,0,117,4.770684624465665
1948,Jewish,101,28,29,29,130,4.875197323201151,131,63,59,54,185,5.225746673713202
1948,Kabardian,4,0,0,0,4,1.6094379124341003,4,10,8,9,13,2.6390573296152584
1948,Kalmyk,8,1,1,1,9,2.302585092994046,11,3,3,2,13,2.6390573296152584
1948,Karelian,0,6,0,0,0,0,0,30,0,0,0,0
1948,Kazakh,266,9,9,11,277,5.627621113690637,268,11,7,7,275,5.62040086571715
1948,Khakas,1,5,3,3,4,1.6094379124341003,1,20,13,12,13,2.6390573296152584
1948,Komi,6,2,0,0,6,1.9459101490553132,6,7,0,0,6,1.9459101490553132
1948,Korean,10,1,0,0,10,2.3978952727983707,10,9,11,9,19,2.995732273553991
1948,Latvian,12,8,6,7,19,2.995732273553991,15,60,61,46,61,4.127134385045092
1948,Lithuanian,28,6,9,10,38,3.6635616461296463,121,70,110,115,236,5.4680601411351315
1948,Mari,10,0,0,0,10,2.3978952727983707,22,1,0,0,22,3.1354942159291497
1948,Moldovan,8,3,7,7,15,2.772588722239781,18,18,47,37,55,4.02535169073515
1948,Mordvin,24,4,3,0,24,3.2188758248682006,30,11,0,0,30,3.4339872044851463
1948,Ossetian,7,0,0,0,7,2.0794415416798357,26,3,2,1,27,3.332204510175204
1948,Polish,216,22,7,13,229,5.438079308923196,677,110,50,43,720,6.580639137284949
1948,Russian,2183,541,556,595,2778,7.929846429742503,2474,1224,982,1078,3552,8.175547596021026
1948,Tatar,108,7,3,9,117,4.770684624465665,126,43,29,28,154,5.043425116919247
1948,Udmurt,47,0,0,0,47,3.871201010907891,47,3,0,0,47,3.871201010907891
1948,Ukrainian,300,52,80,73,373,5.924255797414532,361,165,200,231,592,6.385194398997726
1948,Uzbek,9,0,0,0,9,2.302585092994046,9,3,0,3,12,2.5649493574615367
1948,Yakut,12,1,0,0,12,2.5649493574615367,13,6,0,0,13,2.6390573296152584
1949,Altai,4,1,1,1,5,1.791759469228055,4,4,2,0,4,1.6094379124341003
1949,Armenian,9,3,3,3,12,2.5649493574615367,21,321,378,376,397,5.986452005284438
1949,Balkar,3,2,1,2,5,1.791759469228055,3,49,42,24,27,3.332204510175204
1949,Bashkir,17,3,0,2,19,2.995732273553991,17,37,30,51,68,4.23410650459726
1949,Belorussian,629,27,5,14,643,6.467698726104354,634,142,0,51,685,6.530877627725885
1949,Bulgarian,22,1,0,0,22,3.1354942159291497,36,39,77,0,36,3.6109179126442243
1949,Buryat,21,1,1,1,22,3.1354942159291497,22,6,5,5,27,3.332204510175204
1949,Estonian,9,6,3,4,13,2.6390573296152584,10,98,98,76,86,4.465908118654584
1949,Finnish,2,4,2,2,4,1.6094379124341003,3,61,53,50,53,3.9889840465642745
1949,Georgian,5,3,3,3,8,2.1972245773362196,8,42,56,6,14,2.70805020110221
1949,German,344,57,50,51,395,5.981414211254481,782,1197,1228,1215,1997,7.599901959208498
1949,Greek,8,12,9,8,16,2.833213344056216,19,1628,2165,2193,2212,7.70210434005105
1949,Hungarian,7,2,1,2,9,2.302585092994046,8,19,21,8,16,2.833213344056216
1949,Chechen,30,2,0,1,31,3.4657359027997265,30,167,250,242,272,5.60947179518496
1949,Chinese,51,2,0,2,53,3.9889840465642745,58,8,0,0,58,4.07753744390572
1949,Chuvash,77,5,4,2,79,4.382026634673881,78,33,32,0,78,4.3694478524670215
1949,Japanese,547,8,4,4,551,6.313548046277095,550,25,0,0,550,6.311734809152915
1949,Jewish,231,58,61,64,295,5.69035945432406,244,138,133,123,367,5.908082938168931
1949,Kabardian,0,0,0,0,0,0,0,50,48,45,45,3.828641396489095
1949,Kalmyk,6,1,1,1,7,2.0794415416798357,6,9,9,6,12,2.5649493574615367
1949,Karelian,0,10,7,4,4,1.6094379124341003,0,48,0,0,0,0
1949,Kazakh,395,18,19,14,409,6.016157159698354,396,19,12,0,396,5.983936280687191
1949,Khakas,4,4,2,1,5,1.791759469228055,6,41,28,23,29,3.4011973816621555
1949,Komi,34,1,0,0,34,3.5553480614894135,34,10,0,0,34,3.5553480614894135
1949,Korean,13,1,0,0,13,2.6390573296152584,13,28,41,37,50,3.9318256327243257
1949,Latvian,28,7,3,5,33,3.5263605246161616,33,156,176,159,192,5.262690188904886
1949,Lithuanian,40,0,0,0,40,3.713572066704308,52,18,20,24,76,4.343805421853684
1949,Mari,21,0,0,0,21,3.091042453358316,35,3,0,0,35,3.58351893845611
1949,Moldovan,9,1,0,0,9,2.302585092994046,57,44,123,72,129,4.867534450455582
1949,Mordvin,24,2,0,0,24,3.2188758248682006,26,31,19,23,49,3.912023005428146
1949,Ossetian,6,1,1,1,7,2.0794415416798357,31,18,17,12,43,3.784189633918261
1949,Polish,321,29,11,22,343,5.840641657373398,649,210,99,150,799,6.684611727667927
1949,Russian,2877,680,700,771,3648,8.202208436436448,3170,1541,899,1368,4538,8.420462002456466
1949,Tatar,138,18,15,18,156,5.056245805348308,156,103,81,62,218,5.389071729816501
1949,Udmurt,32,1,0,0,32,3.4965075614664802,33,11,35,29,62,4.143134726391533
1949,Ukrainian,343,37,33,26,369,5.91350300563827,418,219,164,190,608,6.411818267709897
1949,Uzbek,4,6,14,17,21,3.091042453358316,4,21,41,41,45,3.828641396489095
1949,Yakut,8,1,0,0,8,2.1972245773362196,8,23,21,0,8,2.1972245773362196
1950,Altai,3,0,0,0,3,1.3862943611198906,3,0,0,0,3,1.3862943611198906
1950,Armenian,14,1,1,1,15,2.772588722239781,20,5,4,3,23,3.1780538303479458
1950,Balkar,2,2,1,2,4,1.6094379124341003,2,2,0,0,2,1.0986122886681098
1950,Bashkir,18,1,0,0,18,2.9444389791664403,18,6,0,8,26,3.295836866004329
1950,Belorussian,485,17,0,5,490,6.19644412779452,493,117,71,46,539,6.29156913955832
1950,Bulgarian,10,0,0,0,10,2.3978952727983707,20,15,28,20,40,3.713572066704308
1950,Buryat,12,1,1,1,13,2.6390573296152584,12,3,3,3,15,2.772588722239781
1950,Estonian,19,5,3,3,22,3.1354942159291497,25,71,78,69,94,4.553876891600541
1950,Finnish,3,8,7,7,10,2.3978952727983707,3,33,29,26,29,3.4011973816621555
1950,Georgian,9,2,2,1,10,2.3978952727983707,11,9,8,3,14,2.70805020110221
1950,German,398,47,42,43,441,6.091309882077698,781,516,522,517,1298,7.1693500166706
1950,Greek,4,20,21,21,25,3.258096538021482,19,150,178,173,192,5.262690188904886
1950,Hungarian,3,1,0,0,3,1.3862943611198906,3,5,0,0,3,1.3862943611198906
1950,Chechen,67,3,3,4,71,4.276666119016055,69,10,7,12,81,4.406719247264253
1950,Chinese,13,1,0,1,14,2.70805020110221,14,4,0,0,14,2.70805020110221
1950,Chuvash,28,5,15,10,38,3.6635616461296463,28,26,106,65,93,4.543294782270004
1950,Japanese,147,9,6,6,153,5.0369526024136295,148,12,0,5,153,5.0369526024136295
1950,Jewish,135,24,24,25,160,5.081404364984463,143,56,52,49,192,5.262690188904886
1950,Kabardian,2,0,0,0,2,1.0986122886681098,3,1,0,0,3,1.3862943611198906
1950,Kalmyk,5,0,0,0,5,1.791759469228055,6,0,0,0,6,1.9459101490553132
1950,Karelian,1,9,13,7,8,2.1972245773362196,1,41,66,8,9,2.302585092994046
1950,Kazakh,208,15,16,13,221,5.402677381872279,208,16,13,13,221,5.402677381872279
1950,Khakas,1,6,5,4,5,1.791759469228055,1,34,29,27,28,3.367295829986474
1950,Komi,5,0,0,0,5,1.791759469228055,5,7,0,0,5,1.791759469228055
1950,Korean,12,1,0,0,12,2.5649493574615367,12,10,13,12,24,3.2188758248682006
1950,Latvian,51,6,3,4,55,4.02535169073515,65,94,110,100,165,5.111987788356544
1950,Lithuanian,66,6,9,10,76,4.343805421853684,71,16,21,23,94,4.553876891600541
1950,Mari,12,0,0,0,12,2.5649493574615367,22,1,0,0,22,3.1354942159291497
1950,Moldovan,21,1,1,0,21,3.091042453358316,27,18,48,41,68,4.23410650459726
1950,Mordvin,21,9,32,30,51,3.9512437185814275,25,29,83,65,90,4.51085950651685
1950,Ossetian,3,2,2,2,5,1.791759469228055,14,2,0,1,15,2.772588722239781
1950,Polish,258,16,1,8,266,5.58724865840025,379,172,130,137,516,6.248042874508429
1950,Russian,2028,521,536,548,2576,7.854381210652365,2313,1602,1482,1387,3700,8.216358332386156
1950,Tatar,106,7,3,6,112,4.727387818712341,121,21,4,16,137,4.927253685157205
1950,Udmurt,17,1,1,0,17,2.8903717578961645,18,5,11,4,22,3.1354942159291497
1950,Ukrainian,316,27,22,19,335,5.817111159963204,398,283,487,490,888,6.790097235513905
1950,Uzbek,2,4,9,11,13,2.6390573296152584,2,4,2,9,11,2.4849066497880004
1950,Yakut,5,1,0,0,5,1.791759469228055,5,6,0,0,5,1.791759469228055
1951,Altai,3,0,0,0,3,1.3862943611198906,3,0,0,0,3,1.3862943611198906
1951,Armenian,27,3,3,3,30,3.4339872044851463,38,11,12,11,49,3.912023005428146
1951,Balkar,1,2,1,2,3,1.3862943611198906,1,4,2,0,1,0.6931471805599453
1951,Bashkir,6,0,0,0,6,1.9459101490553132,6,4,0,5,11,2.4849066497880004
1951,Belorussian,404,16,2,5,409,6.016157159698354,438,55,7,0,438,6.0844994130751715
1951,Bulgarian,11,0,0,0,11,2.4849066497880004,24,5,7,0,24,3.2188758248682006
1951,Buryat,7,1,1,1,8,2.1972245773362196,7,3,3,3,10,2.3978952727983707
1951,Estonian,27,6,5,5,32,3.4965075614664802,29,23,20,13,42,3.7612001156935624
1951,Finnish,10,1,0,0,10,2.3978952727983707,10,17,14,12,22,3.1354942159291497
1951,Georgian,6,1,0,0,6,1.9459101490553132,8,8,9,3,11,2.4849066497880004
1951,German,640,32,27,27,667,6.504288173536645,989,466,483,486,1475,7.297091005160418
1951,Greek,11,10,9,8,19,2.995732273553991,30,87,102,88,118,4.77912349311153
1951,Hungarian,6,1,0,1,7,2.0794415416798357,6,3,0,0,6,1.9459101490553132
1951,Chechen,74,3,3,4,78,4.3694478524670215,74,27,37,39,113,4.736198448394496
1951,Chinese,9,0,0,0,9,2.302585092994046,10,3,0,0,10,2.3978952727983707
1951,Chuvash,18,2,0,0,18,2.9444389791664403,20,14,43,0,20,3.044522437723423
1951,Japanese,5,7,4,3,8,2.1972245773362196,5,8,0,0,5,1.791759469228055
1951,Jewish,170,28,29,30,200,5.303304908059076,180,56,55,53,233,5.455321115357702
1951,Kabardian,2,0,0,0,2,1.0986122886681098,2,3,1,2,4,1.6094379124341003
1951,Kalmyk,2,0,0,0,2,1.0986122886681098,2,0,0,0,2,1.0986122886681098
1951,Karelian,0,5,0,0,0,0,0,21,13,0,0,0
1951,Kazakh,171,12,13,7,178,5.187385805840755,173,12,11,4,177,5.181783550292085
1951,Khakas,1,3,2,1,2,1.0986122886681098,2,10,5,3,5,1.791759469228055
1951,Komi,3,0,0,0,3,1.3862943611198906,3,4,0,0,3,1.3862943611198906
1951,Korean,8,2,3,3,11,2.4849066497880004,8,9,13,12,20,3.044522437723423
1951,Latvian,62,8,7,8,70,4.2626798770413155,75,32,31,21,96,4.574710978503383
1951,Lithuanian,121,8,12,13,134,4.90527477843843,132,73,118,121,253,5.537334267018537
1951,Mari,8,0,0,0,8,2.1972245773362196,15,1,0,0,15,2.772588722239781
1951,Moldovan,82,2,4,5,87,4.477336814478207,87,67,216,217,304,5.720311776607412
1951,Mordvin,16,1,0,0,16,2.833213344056216,19,12,17,0,19,2.995732273553991
1951,Ossetian,2,0,0,0,2,1.0986122886681098,21,0,0,0,21,3.091042453358316
1951,Polish,314,14,2,5,319,5.768320995793772,440,71,36,17,457,6.126869184114185
1951,Russian,1609,417,429,502,2111,7.655390644826152,1897,864,749,895,2792,7.934871565945177
1951,Tatar,55,8,6,8,63,4.1588830833596715,66,15,4,9,75,4.330733340286331
1951,Udmurt,30,0,0,0,30,3.4339872044851463,31,1,0,0,31,3.4657359027997265
1951,Ukrainian,343,26,28,21,364,5.8998973535824915,444,153,247,183,627,6.4425401664681985
1951,Uzbek,8,6,16,17,25,3.258096538021482,8,7,14,17,25,3.258096538021482
1951,Yakut,2,0,0,0,2,1.0986122886681098,2,4,0,0,2,1.0986122886681098
1952,Altai,0,0,0,0,0,0,0,0,0,0,0,0
1952,Armenian,19,0,0,0,19,2.995732273553991,22,4,4,4,26,3.295836866004329
1952,Balkar,0,0,0,0,0,0,0,1,0,0,0,0
1952,Bashkir,6,3,4,5,11,2.4849066497880004,6,8,10,15,21,3.091042453358316
1952,Belorussian,71,6,0,2,73,4.30406509320417,85,28,11,23,108,4.6913478822291435
1952,Bulgarian,4,1,2,2,6,1.9459101490553132,14,4,7,7,21,3.091042453358316
1952,Buryat,3,0,0,0,3,1.3862943611198906,3,2,2,2,5,1.791759469228055
1952,Estonian,16,4,4,4,20,3.044522437723423,19,9,7,3,22,3.1354942159291497
1952,Finnish,1,3,3,3,4,1.6094379124341003,1,4,2,1,2,1.0986122886681098
1952,Georgian,8,0,0,0,8,2.1972245773362196,8,2,1,1,9,2.302585092994046
1952,German,180,18,17,17,197,5.288267030694535,481,396,422,429,910,6.814542897259958
1952,Greek,5,5,5,5,10,2.3978952727983707,20,21,21,22,42,3.7612001156935624
1952,Hungarian,1,1,2,2,3,1.3862943611198906,1,1,0,0,1,0.6931471805599453
1952,Chechen,15,5,7,8,23,3.1780538303479458,16,7,9,10,26,3.295836866004329
1952,Chinese,4,1,0,0,4,1.6094379124341003,4,1,0,0,4,1.6094379124341003
1952,Chuvash,11,3,19,19,30,3.4339872044851463,11,4,0,10,21,3.091042453358316
1952,Japanese,0,3,2,0,0,0,0,3,0,0,0,0
1952,Jewish,42,9,9,10,52,3.970291913552122,55,16,15,13,68,4.23410650459726
1952,Kabardian,0,1,1,1,1,0.6931471805599453,1,3,2,3,4,1.6094379124341003
1952,Kalmyk,2,0,0,0,2,1.0986122886681098,2,0,0,0,2,1.0986122886681098
1952,Karelian,0,2,0,0,0,0,0,4,0,0,0,0
1952,Kazakh,25,8,9,2,27,3.332204510175204,26,8,8,2,28,3.367295829986474
1952,Khakas,0,0,0,0,0,0,0,4,2,2,2,1.0986122886681098
1952,Komi,5,0,0,0,5,1.791759469228055,5,0,0,0,5,1.791759469228055
1952,Korean,6,1,1,2,8,2.1972245773362196,6,4,6,6,12,2.5649493574615367
1952,Latvian,44,1,0,0,44,3.8066624897703196,51,7,4,0,51,3.9512437185814275
1952,Lithuanian,54,1,1,2,56,4.04305126783455,55,9,13,14,69,4.248495242049359
1952,Mari,3,0,0,0,3,1.3862943611198906,8,0,0,0,8,2.1972245773362196
1952,Moldovan,44,0,0,0,44,3.8066624897703196,46,0,0,0,46,3.8501476017100584
1952,Mordvin,10,1,0,0,10,2.3978952727983707,10,1,0,0,10,2.3978952727983707
1952,Ossetian,3,0,0,0,3,1.3862943611198906,17,2,2,2,19,2.995732273553991
1952,Polish,71,7,3,5,76,4.343805421853684,94,29,13,12,106,4.672828834461906
1952,Russian,683,142,140,144,827,6.71901315438526,850,298,228,308,1158,7.055312843339752
1952,Tatar,28,6,6,1,29,3.4011973816621555,41,9,5,0,41,3.7376696182833684
1952,Udmurt,13,0,0,0,13,2.6390573296152584,14,0,0,0,14,2.70805020110221
1952,Ukrainian,188,12,15,16,204,5.3230099791384085,219,43,52,68,287,5.662960480135946
1952,Uzbek,2,6,17,17,19,2.995732273553991,2,6,15,16,18,2.9444389791664403
1952,Yakut,4,0,0,0,4,1.6094379124341003,4,0,0,0,4,1.6094379124341003
1953,Altai,0,0,0,0,0,0,0,0,0,0,0,0
1953,Armenian,7,0,0,0,7,2.0794415416798357,10,1,1,1,11,2.4849066497880004
1953,Balkar,0,0,0,0,0,0,0,1,0,0,0,0
1953,Bashkir,5,1,1,1,6,1.9459101490553132,5,3,1,4,9,2.302585092994046
1953,Belorussian,69,10,10,11,80,4.394449154672439,69,18,1,17,86,4.465908118654584
1953,Bulgarian,0,0,0,0,0,0,6,3,5,5,11,2.4849066497880004
1953,Buryat,0,1,1,1,1,0.6931471805599453,0,1,1,1,1,0.6931471805599453
1953,Estonian,16,3,3,3,19,2.995732273553991,21,6,4,0,21,3.091042453358316
1953,Finnish,5,0,0,0,5,1.791759469228055,5,4,3,2,7,2.0794415416798357
1953,Georgian,2,0,0,0,2,1.0986122886681098,4,1,0,0,4,1.6094379124341003
1953,German,49,6,4,4,53,3.9889840465642745,287,323,345,350,637,6.45833828334479
1953,Greek,4,5,5,5,9,2.302585092994046,15,18,19,19,34,3.5553480614894135
1953,Hungarian,0,0,0,0,0,0,0,2,2,1,1,0.6931471805599453
1953,Chechen,5,1,1,1,6,1.9459101490553132,5,1,0,0,5,1.791759469228055
1953,Chinese,3,1,0,1,4,1.6094379124341003,3,1,0,0,3,1.3862943611198906
1953,Chuvash,9,1,0,0,9,2.302585092994046,9,2,0,0,9,2.302585092994046
1953,Japanese,0,3,2,1,1,0.6931471805599453,0,3,0,0,0,0
1953,Jewish,65,9,9,10,75,4.330733340286331,73,18,18,16,89,4.499809670330265
1953,Kabardian,1,1,1,1,2,1.0986122886681098,1,2,2,2,3,1.3862943611198906
1953,Kalmyk,0,0,0,0,0,0,3,0,0,0,3,1.3862943611198906
1953,Karelian,0,2,1,0,0,0,0,5,0,0,0,0
1953,Kazakh,23,9,10,6,29,3.4011973816621555,23,11,12,8,31,3.4657359027997265
1953,Khakas,0,3,3,3,3,1.3862943611198906,0,4,2,3,3,1.3862943611198906
1953,Komi,4,0,0,0,4,1.6094379124341003,4,0,0,0,4,1.6094379124341003
1953,Korean,1,0,0,0,1,0.6931471805599453,1,3,4,4,5,1.791759469228055
1953,Latvian,42,4,4,5,47,3.871201010907891,45,10,9,4,49,3.912023005428146
1953,Lithuanian,46,2,3,3,49,3.912023005428146,49,2,2,3,52,3.970291913552122
1953,Mari,5,0,0,0,5,1.791759469228055,8,1,3,4,12,2.5649493574615367
1953,Moldovan,26,0,0,0,26,3.295836866004329,33,0,0,0,33,3.5263605246161616
1953,Mordvin,10,0,0,0,10,2.3978952727983707,12,2,0,0,12,2.5649493574615367
1953,Ossetian,3,0,0,0,3,1.3862943611198906,7,0,0,0,7,2.0794415416798357
1953,Polish,29,2,0,0,29,3.4011973816621555,35,9,0,0,35,3.58351893845611
1953,Russian,489,129,129,142,631,6.448889394146858,560,241,188,237,797,6.682108597449809
1953,Tatar,22,6,6,5,27,3.332204510175204,26,10,7,7,33,3.5263605246161616
1953,Udmurt,9,0,0,0,9,2.302585092994046,10,0,0,0,10,2.3978952727983707
1953,Ukrainian,150,13,19,19,169,5.135798437050262,174,23,15,29,203,5.318119993844216
1953,Uzbek,0,4,11,11,11,2.4849066497880004,0,4,9,11,11,2.4849066497880004
1953,Yakut,3,1,2,2,5,1.791759469228055,3,3,4,6,9,2.302585092994046
1954,Altai,0,0,0,0,0,0,0,1,2,2,2,1.0986122886681098
1954,Armenian,0,0,0,0,0,0,3,1,1,1,4,1.6094379124341003
1954,Balkar,0,0,0,0,0,0,0,0,0,0,0,0
1954,Bashkir,0,0,0,0,0,0,0,0,0,0,0,0
1954,Belorussian,5,1,1,1,6,1.9459101490553132,5,5,0,5,10,2.3978952727983707
1954,Bulgarian,0,0,0,0,0,0,7,0,0,0,7,2.0794415416798357
1954,Buryat,0,0,0,0,0,0,0,0,0,0,0,0
1954,Estonian,3,0,0,0,3,1.3862943611198906,4,4,4,1,5,1.791759469228055
1954,Finnish,0,0,0,0,0,0,0,2,2,1,1,0.6931471805599453
1954,Georgian,3,0,0,0,3,1.3862943611198906,3,2,3,3,6,1.9459101490553132
1954,German,1,3,3,3,4,1.6094379124341003,167,171,184,186,353,5.869296913133774
1954,Greek,0,0,0,0,0,0,7,10,11,12,19,2.995732273553991
1954,Hungarian,0,0,0,0,0,0,0,0,0,0,0,0
1954,Chechen,0,1,2,2,2,1.0986122886681098,0,1,1,1,1,0.6931471805599453
1954,Chinese,0,0,0,0,0,0,0,0,0,0,0,0
1954,Chuvash,3,0,0,0,3,1.3862943611198906,3,1,0,5,8,2.1972245773362196
1954,Japanese,0,0,0,0,0,0,0,1,0,0,0,0
1954,Jewish,1,1,1,1,2,1.0986122886681098,2,6,6,5,7,2.0794415416798357
1954,Kabardian,0,0,0,0,0,0,0,2,2,2,2,1.0986122886681098
1954,Kalmyk,1,0,0,0,1,0.6931471805599453,6,0,0,0,6,1.9459101490553132
1954,Karelian,0,1,5,5,5,1.791759469228055,0,1,0,0,0,0
1954,Kazakh,0,0,0,0,0,0,0,0,0,0,0,0
1954,Khakas,0,0,0,0,0,0,0,4,4,4,4,1.6094379124341003
1954,Komi,0,0,0,0,0,0,0,0,0,0,0,0
1954,Korean,1,0,0,0,1,0.6931471805599453,1,3,5,5,6,1.9459101490553132
1954,Latvian,0,0,0,0,0,0,3,9,11,8,11,2.4849066497880004
1954,Lithuanian,9,0,0,0,9,2.302585092994046,9,1,1,1,10,2.3978952727983707
1954,Mari,0,0,0,0,0,0,0,0,0,0,0,0
1954,Moldovan,7,0,0,0,7,2.0794415416798357,7,0,0,0,7,2.0794415416798357
1954,Mordvin,1,0,0,0,1,0.6931471805599453,2,0,0,0,2,1.0986122886681098
1954,Ossetian,0,0,0,0,0,0,0,0,0,0,0,0
1954,Polish,5,1,1,1,6,1.9459101490553132,7,6,0,1,8,2.1972245773362196
1954,Russian,52,8,7,5,57,4.060443010546419,82,51,19,50,132,4.890349128221754
1954,Tatar,1,0,0,0,1,0.6931471805599453,6,2,1,2,8,2.1972245773362196
1954,Udmurt,0,0,0,0,0,0,0,0,0,0,0,0
1954,Ukrainian,11,1,1,2,13,2.6390573296152584,27,3,0,0,27,3.332204510175204
1954,Uzbek,0,1,3,3,3,1.3862943611198906,0,1,2,3,3,1.3862943611198906
1954,Yakut,0,0,0,0,0,0,0,0,0,0,0,0
1955,Altai,0,0,0,0,0,0,0,0,0,0,0,0
1955,Armenian,1,0,0,0,1,0.6931471805599453,3,0,0,0,3,1.3862943611198906
1955,Balkar,1,0,0,0,1,0.6931471805599453,1,0,0,0,1,0.6931471805599453
1955,Bashkir,0,0,0,0,0,0,0,0,0,0,0,0
1955,Belorussian,4,0,0,0,4,1.6094379124341003,8,2,0,0,8,2.1972245773362196
1955,Bulgarian,0,0,0,0,0,0,1,1,2,2,3,1.3862943611198906
1955,Buryat,0,0,0,0,0,0,0,0,0,0,0,0
1955,Estonian,2,0,0,0,2,1.0986122886681098,3,3,3,2,5,1.791759469228055
1955,Finnish,0,0,0,0,0,0,0,0,0,0,0,0
1955,Georgian,0,0,0,0,0,0,0,1,1,1,1,0.6931471805599453
1955,German,0,1,1,1,1,0.6931471805599453,77,102,110,111,188,5.241747015059643
1955,Greek,0,0,0,0,0,0,5,2,2,1,6,1.9459101490553132
1955,Hungarian,1,0,0,0,1,0.6931471805599453,1,0,0,0,1,0.6931471805599453
1955,Chechen,0,0,0,0,0,0,0,0,0,0,0,0
1955,Chinese,0,0,0,0,0,0,0,0,0,0,0,0
1955,Chuvash,0,0,0,0,0,0,0,0,0,0,0,0
1955,Japanese,0,1,1,1,1,0.6931471805599453,0,1,0,0,0,0
1955,Jewish,4,0,0,0,4,1.6094379124341003,5,1,1,0,5,1.791759469228055
1955,Kabardian,0,0,0,0,0,0,0,0,0,0,0,0
1955,Kalmyk,0,0,0,0,0,0,3,0,0,0,3,1.3862943611198906
1955,Karelian,0,0,0,0,0,0,0,0,0,0,0,0
1955,Kazakh,2,0,0,0,2,1.0986122886681098,2,1,1,0,2,1.0986122886681098
1955,Khakas,0,0,0,0,0,0,0,0,0,0,0,0
1955,Komi,0,0,0,0,0,0,0,0,0,0,0,0
1955,Korean,1,0,0,0,1,0.6931471805599453,1,0,0,0,1,0.6931471805599453
1955,Latvian,4,0,0,0,4,1.6094379124341003,4,2,2,0,4,1.6094379124341003
1955,Lithuanian,3,0,0,0,3,1.3862943611198906,3,0,0,0,3,1.3862943611198906
1955,Mari,0,0,0,0,0,0,0,0,0,0,0,0
1955,Moldovan,0,0,0,0,0,0,0,0,0,0,0,0
1955,Mordvin,0,0,0,0,0,0,1,0,0,0,1,0.6931471805599453
1955,Ossetian,0,0,0,0,0,0,1,0,0,0,1,0.6931471805599453
1955,Polish,24,1,1,1,25,3.258096538021482,27,7,5,6,33,3.5263605246161616
1955,Russian,55,10,10,13,68,4.23410650459726,80,29,12,35,115,4.7535901911063645
1955,Tatar,0,0,0,0,0,0,0,0,0,0,0,0
1955,Udmurt,0,0,0,0,0,0,0,0,0,0,0,0
1955,Ukrainian,36,2,4,4,40,3.713572066704308,45,5,3,8,53,3.9889840465642745
1955,Uzbek,0,0,0,0,0,0,0,1,2,3,3,1.3862943611198906
1955,Yakut,0,0,0,0,0,0,0,0,0,0,0,0
1956,Altai,0,0,0,0,0,0,0,0,0,0,0,0
1956,Armenian,5,1,1,1,6,1.9459101490553132,6,1,1,1,7,2.0794415416798357
1956,Balkar,0,0,0,0,0,0,0,0,0,0,0,0
1956,Bashkir,2,0,0,0,2,1.0986122886681098,2,0,0,0,2,1.0986122886681098
1956,Belorussian,10,1,0,0,10,2.3978952727983707,10,2,1,0,10,2.3978952727983707
1956,Bulgarian,0,0,0,0,0,0,0,0,0,0,0,0
1956,Buryat,0,0,0,0,0,0,0,0,0,0,0,0
1956,Estonian,12,0,0,0,12,2.5649493574615367,12,0,0,0,12,2.5649493574615367
1956,Finnish,0,0,0,0,0,0,0,0,0,0,0,0
1956,Georgian,13,0,0,0,13,2.6390573296152584,14,0,0,0,14,2.70805020110221
1956,German,3,1,1,1,4,1.6094379124341003,7,8,8,8,15,2.772588722239781
1956,Greek,0,0,0,0,0,0,1,1,1,1,2,1.0986122886681098
1956,Hungarian,2,0,0,0,2,1.0986122886681098,2,0,0,0,2,1.0986122886681098
1956,Chechen,0,0,0,0,0,0,0,0,0,0,0,0
1956,Chinese,0,0,0,0,0,0,0,0,0,0,0,0
1956,Chuvash,1,0,0,0,1,0.6931471805599453,1,0,0,0,1,0.6931471805599453
1956,Japanese,0,0,0,0,0,0,0,2,2,2,2,1.0986122886681098
1956,Jewish,7,1,1,1,8,2.1972245773362196,9,2,2,2,11,2.4849066497880004
1956,Kabardian,0,0,0,0,0,0,0,0,0,0,0,0
1956,Kalmyk,0,0,0,0,0,0,0,0,0,0,0,0
1956,Karelian,0,0,0,0,0,0,0,0,0,0,0,0
1956,Kazakh,0,0,0,0,0,0,0,0,0,0,0,0
1956,Khakas,0,0,0,0,0,0,0,1,1,1,1,0.6931471805599453
1956,Komi,1,1,4,4,5,1.791759469228055,1,1,3,3,4,1.6094379124341003
1956,Korean,0,0,0,0,0,0,0,0,0,0,0,0
1956,Latvian,10,0,0,0,10,2.3978952727983707,10,0,0,0,10,2.3978952727983707
1956,Lithuanian,12,0,0,0,12,2.5649493574615367,13,0,0,0,13,2.6390573296152584
1956,Mari,0,0,0,0,0,0,0,0,0,0,0,0
1956,Moldovan,2,0,0,0,2,1.0986122886681098,2,1,3,3,5,1.791759469228055
1956,Mordvin,2,0,0,0,2,1.0986122886681098,4,0,0,0,4,1.6094379124341003
1956,Ossetian,1,0,0,0,1,0.6931471805599453,1,0,0,0,1,0.6931471805599453
1956,Polish,21,1,0,1,22,3.1354942159291497,22,2,1,1,23,3.1780538303479458
1956,Russian,131,27,28,31,162,5.093750200806762,174,43,43,52,226,5.424950017481403
1956,Tatar,4,0,0,0,4,1.6094379124341003,5,1,1,1,6,1.9459101490553132
1956,Udmurt,0,0,0,0,0,0,1,0,0,0,1,0.6931471805599453
1956,Ukrainian,63,4,8,7,70,4.2626798770413155,66,5,8,6,72,4.290459441148391
1956,Uzbek,0,0,0,0,0,0,0,1,3,3,3,1.3862943611198906
1956,Yakut,0,0,0,0,0,0,0,0,0,0,0,0
1957,Altai,1,0,0,0,1,0.6931471805599453,1,0,0,0,1,0.6931471805599453
1957,Armenian,24,0,0,0,24,3.2188758248682006,26,0,0,0,26,3.295836866004329
1957,Balkar,0,0,0,0,0,0,0,0,0,0,0,0
1957,Bashkir,1,0,0,0,1,0.6931471805599453,1,1,1,2,3,1.3862943611198906
1957,Belorussian,75,1,0,0,75,4.330733340286331,77,4,0,1,78,4.3694478524670215
1957,Bulgarian,1,0,0,0,1,0.6931471805599453,1,0,0,0,1,0.6931471805599453
1957,Buryat,1,0,0,0,1,0.6931471805599453,1,1,1,1,2,1.0986122886681098
1957,Estonian,21,0,0,0,21,3.091042453358316,22,0,0,0,22,3.1354942159291497
1957,Finnish,1,0,0,0,1,0.6931471805599453,1,0,0,0,1,0.6931471805599453
1957,Georgian,6,0,0,0,6,1.9459101490553132,6,1,1,1,7,2.0794415416798357
1957,German,21,4,3,3,24,3.2188758248682006,23,7,6,6,29,3.4011973816621555
1957,Greek,5,0,0,0,5,1.791759469228055,5,1,0,0,5,1.791759469228055
1957,Hungarian,6,0,0,0,6,1.9459101490553132,6,0,0,0,6,1.9459101490553132
1957,Chechen,1,1,1,2,3,1.3862943611198906,2,2,3,3,5,1.791759469228055
1957,Chinese,0,0,0,0,0,0,0,0,0,0,0,0
1957,Chuvash,7,0,0,0,7,2.0794415416798357,8,0,0,0,8,2.1972245773362196
1957,Japanese,0,1,1,0,0,0,0,1,0,0,0,0
1957,Jewish,35,1,1,1,36,3.6109179126442243,35,1,1,1,36,3.6109179126442243
1957,Kabardian,0,0,0,0,0,0,0,0,0,0,0,0
1957,Kalmyk,0,0,0,0,0,0,0,0,0,0,0,0
1957,Karelian,0,1,1,0,0,0,0,1,0,0,0,0
1957,Kazakh,4,3,3,2,6,1.9459101490553132,4,3,3,2,6,1.9459101490553132
1957,Khakas,0,1,1,1,1,0.6931471805599453,0,2,2,2,2,1.0986122886681098
1957,Komi,1,0,0,0,1,0.6931471805599453,1,0,0,0,1,0.6931471805599453
1957,Korean,1,0,0,0,1,0.6931471805599453,1,0,0,0,1,0.6931471805599453
1957,Latvian,31,0,0,0,31,3.4657359027997265,32,0,0,0,32,3.4965075614664802
1957,Lithuanian,101,0,0,0,101,4.624972813284271,102,0,0,0,102,4.634728988229636
1957,Mari,1,0,0,0,1,0.6931471805599453,2,0,0,0,2,1.0986122886681098
1957,Moldovan,30,0,0,0,30,3.4339872044851463,32,1,3,3,35,3.58351893845611
1957,Mordvin,9,1,3,3,12,2.5649493574615367,10,1,2,1,11,2.4849066497880004
1957,Ossetian,1,0,0,0,1,0.6931471805599453,2,0,0,0,2,1.0986122886681098
1957,Polish,27,1,0,1,28,3.367295829986474,29,1,0,0,29,3.4011973816621555
1957,Russian,819,83,89,100,919,6.824373670043086,905,121,127,148,1053,6.960347729101308
1957,Tatar,17,1,1,1,18,2.9444389791664403,17,1,0,0,17,2.8903717578961645
1957,Udmurt,2,0,0,0,2,1.0986122886681098,2,0,0,0,2,1.0986122886681098
1957,Ukrainian,343,3,2,0,343,5.840641657373398,353,7,8,4,357,5.8805329864007
1957,Uzbek,0,1,3,3,3,1.3862943611198906,0,1,2,3,3,1.3862943611198906
1957,Yakut,0,0,0,0,0,0,0,0,0,0,0,0
1958,Altai,0,0,0,0,0,0,0,0,0,0,0,0
1958,Armenian,7,0,0,0,7,2.0794415416798357,8,0,0,0,8,2.1972245773362196
1958,Balkar,0,0,0,0,0,0,0,0,0,0,0,0
1958,Bashkir,2,0,0,0,2,1.0986122886681098,2,0,0,0,2,1.0986122886681098
1958,Belorussian,27,3,3,3,30,3.4339872044851463,28,4,4,3,31,3.4657359027997265
1958,Bulgarian,0,0,0,0,0,0,0,0,0,0,0,0
1958,Buryat,0,0,0,0,0,0,1,0,0,0,1,0.6931471805599453
1958,Estonian,8,0,0,0,8,2.1972245773362196,8,0,0,0,8,2.1972245773362196
1958,Finnish,0,0,0,0,0,0,0,0,0,0,0,0
1958,Georgian,7,0,0,0,7,2.0794415416798357,7,0,0,0,7,2.0794415416798357
1958,German,20,0,0,0,20,3.044522437723423,21,0,0,0,21,3.091042453358316
1958,Greek,2,1,1,0,2,1.0986122886681098,2,1,1,0,2,1.0986122886681098
1958,Hungarian,7,0,0,0,7,2.0794415416798357,7,0,0,0,7,2.0794415416798357
1958,Chechen,0,1,1,2,2,1.0986122886681098,0,1,1,1,1,0.6931471805599453
1958,Chinese,1,0,0,0,1,0.6931471805599453,1,0,0,0,1,0.6931471805599453
1958,Chuvash,8,0,0,0,8,2.1972245773362196,8,0,0,0,8,2.1972245773362196
1958,Japanese,0,0,0,0,0,0,0,0,0,0,0,0
1958,Jewish,26,1,1,1,27,3.332204510175204,27,1,1,1,28,3.367295829986474
1958,Kabardian,0,0,0,0,0,0,0,0,0,0,0,0
1958,Kalmyk,0,0,0,0,0,0,0,0,0,0,0,0
1958,Karelian,1,0,0,0,1,0.6931471805599453,1,1,1,0,1,0.6931471805599453
1958,Kazakh,2,0,0,0,2,1.0986122886681098,2,0,0,0,2,1.0986122886681098
1958,Khakas,0,0,0,0,0,0,0,0,0,0,0,0
1958,Komi,2,0,0,0,2,1.0986122886681098,2,0,0,0,2,1.0986122886681098
1958,Korean,0,0,0,0,0,0,0,0,0,0,0,0
1958,Latvian,21,1,1,1,22,3.1354942159291497,22,1,1,1,23,3.1780538303479458
1958,Lithuanian,36,3,5,5,41,3.7376696182833684,38,3,5,5,43,3.784189633918261
1958,Mari,2,0,0,0,2,1.0986122886681098,2,1,5,5,7,2.0794415416798357
1958,Moldovan,30,2,6,7,37,3.6375861597263857,30,3,10,10,40,3.713572066704308
1958,Mordvin,5,0,0,0,5,1.791759469228055,5,0,0,0,5,1.791759469228055
1958,Ossetian,5,0,0,0,5,1.791759469228055,5,0,0,0,5,1.791759469228055
1958,Polish,11,0,0,0,11,2.4849066497880004,12,1,0,0,12,2.5649493574615367
1958,Russian,517,46,48,64,581,6.366470447731438,592,68,71,84,676,6.517671272912275
1958,Tatar,8,1,1,1,9,2.302585092994046,8,1,1,1,9,2.302585092994046
1958,Udmurt,5,0,0,0,5,1.791759469228055,5,0,0,0,5,1.791759469228055
1958,Ukrainian,211,3,4,0,211,5.356586274672012,216,5,7,1,217,5.384495062789089
1958,Uzbek,0,0,0,0,0,0,0,0,0,0,0,0
1958,Yakut,0,0,0,0,0,0,0,0,0,0,0,0
1959,Altai,0,0,0,0,0,0,0,0,0,0,0,0
1959,Armenian,1,0,0,0,1,0.6931471805599453,1,0,0,0,1,0.6931471805599453
1959,Balkar,0,0,0,0,0,0,0,0,0,0,0,0
1959,Bashkir,0,0,0,0,0,0,1,0,0,0,1,0.6931471805599453
1959,Belorussian,10,0,0,0,10,2.3978952727983707,11,0,0,0,11,2.4849066497880004
1959,Bulgarian,0,0,0,0,0,0,0,0,0,0,0,0
1959,Buryat,0,0,0,0,0,0,0,0,0,0,0,0
1959,Estonian,12,0,0,0,12,2.5649493574615367,12,0,0,0,12,2.5649493574615367
1959,Finnish,0,0,0,0,0,0,0,0,0,0,0,0
1959,Georgian,2,0,0,0,2,1.0986122886681098,2,1,2,2,4,1.6094379124341003
1959,German,9,0,0,0,9,2.302585092994046,9,0,0,0,9,2.302585092994046
1959,Greek,2,1,1,1,3,1.3862943611198906,2,1,1,1,3,1.3862943611198906
1959,Hungarian,0,0,0,0,0,0,1,1,2,2,3,1.3862943611198906
1959,Chechen,3,0,0,0,3,1.3862943611198906,3,0,0,0,3,1.3862943611198906
1959,Chinese,0,0,0,0,0,0,0,0,0,0,0,0
1959,Chuvash,23,0,0,0,23,3.1780538303479458,23,0,0,0,23,3.1780538303479458
1959,Japanese,0,0,0,0,0,0,0,1,1,1,1,0.6931471805599453
1959,Jewish,6,0,0,0,6,1.9459101490553132,6,0,0,0,6,1.9459101490553132
1959,Kabardian,0,0,0,0,0,0,0,0,0,0,0,0
1959,Kalmyk,0,0,0,0,0,0,0,0,0,0,0,0
1959,Karelian,0,0,0,0,0,0,0,0,0,0,0,0
1959,Kazakh,2,0,0,0,2,1.0986122886681098,2,0,0,0,2,1.0986122886681098
1959,Khakas,0,0,0,0,0,0,0,0,0,0,0,0
1959,Komi,0,0,0,0,0,0,0,0,0,0,0,0
1959,Korean,0,0,0,0,0,0,0,0,0,0,0,0
1959,Latvian,10,0,0,0,10,2.3978952727983707,10,0,0,0,10,2.3978952727983707
1959,Lithuanian,8,0,0,0,8,2.1972245773362196,9,0,0,0,9,2.302585092994046
1959,Mari,0,0,0,0,0,0,0,1,5,5,5,1.791759469228055
1959,Moldovan,9,0,0,0,9,2.302585092994046,9,0,0,0,9,2.302585092994046
1959,Mordvin,0,0,0,0,0,0,1,1,5,4,5,1.791759469228055
1959,Ossetian,1,0,0,0,1,0.6931471805599453,1,0,0,0,1,0.6931471805599453
1959,Polish,6,0,0,0,6,1.9459101490553132,6,0,0,0,6,1.9459101490553132
1959,Russian,153,24,26,31,184,5.220355825078324,191,30,31,32,223,5.4116460518550396
1959,Tatar,6,0,0,0,6,1.9459101490553132,7,0,0,0,7,2.0794415416798357
1959,Udmurt,0,0,0,0,0,0,1,0,0,0,1,0.6931471805599453
1959,Ukrainian,105,3,6,5,110,4.709530201312334,111,6,12,12,123,4.820281565605037
1959,Uzbek,0,0,0,0,0,0,0,0,0,0,0,0
1959,Yakut,0,0,0,0,0,0,0,0,0,0,0,0
1960,Altai,0,0,0,0,0,0,0,0,0,0,0,0
1960,Armenian,1,0,0,0,1,0.6931471805599453,1,0,0,0,1,0.6931471805599453
1960,Balkar,0,0,0,0,0,0,0,0,0,0,0,0
1960,Bashkir,0,0,0,0,0,0,0,0,0,0,0,0
1960,Belorussian,8,0,0,0,8,2.1972245773362196,8,1,1,2,10,2.3978952727983707
1960,Bulgarian,0,0,0,0,0,0,0,0,0,0,0,0
1960,Buryat,0,0,0,0,0,0,0,0,0,0,0,0
1960,Estonian,1,0,0,0,1,0.6931471805599453,1,0,0,0,1,0.6931471805599453
1960,Finnish,0,0,0,0,0,0,0,0,0,0,0,0
1960,Georgian,0,0,0,0,0,0,0,0,0,0,0,0
1960,German,2,0,0,0,2,1.0986122886681098,2,1,1,1,3,1.3862943611198906
1960,Greek,0,0,0,0,0,0,0,0,0,0,0,0
1960,Hungarian,0,0,0,0,0,0,0,0,0,0,0,0
1960,Chechen,0,0,0,0,0,0,0,0,0,0,0,0
1960,Chinese,0,0,0,0,0,0,0,0,0,0,0,0
1960,Chuvash,0,0,0,0,0,0,0,0,0,0,0,0
1960,Japanese,0,0,0,0,0,0,0,0,0,0,0,0
1960,Jewish,3,0,0,0,3,1.3862943611198906,4,0,0,0,4,1.6094379124341003
1960,Kabardian,1,0,0,0,1,0.6931471805599453,1,0,0,0,1,0.6931471805599453
1960,Kalmyk,0,0,0,0,0,0,0,0,0,0,0,0
1960,Karelian,0,0,0,0,0,0,0,0,0,0,0,0
1960,Kazakh,3,0,0,0,3,1.3862943611198906,3,0,0,0,3,1.3862943611198906
1960,Khakas,0,0,0,0,0,0,0,0,0,0,0,0
1960,Komi,0,0,0,0,0,0,0,0,0,0,0,0
1960,Korean,0,0,0,0,0,0,0,0,0,0,0,0
1960,Latvian,25,0,0,0,25,3.258096538021482,26,0,0,0,26,3.295836866004329
1960,Lithuanian,5,0,0,0,5,1.791759469228055,5,0,0,0,5,1.791759469228055
1960,Mari,2,0,0,0,2,1.0986122886681098,2,0,0,0,2,1.0986122886681098
1960,Moldovan,6,0,0,0,6,1.9459101490553132,7,0,0,0,7,2.0794415416798357
1960,Mordvin,0,0,0,0,0,0,0,0,0,0,0,0
1960,Ossetian,1,0,0,0,1,0.6931471805599453,2,0,0,0,2,1.0986122886681098
1960,Polish,0,0,0,0,0,0,0,0,0,0,0,0
1960,Russian,46,8,9,11,57,4.060443010546419,61,13,14,17,78,4.3694478524670215
1960,Tatar,6,0,0,0,6,1.9459101490553132,6,0,0,0,6,1.9459101490553132
1960,Udmurt,0,0,0,0,0,0,0,0,0,0,0,0
1960,Ukrainian,30,0,0,0,30,3.4339872044851463,37,0,0,0,37,3.6375861597263857
1960,Uzbek,0,0,0,0,0,0,0,0,0,0,0,0
1960,Yakut,0,0,0,0,0,0,0,0,0,0,0,0
